-aufgestanden	(aufgestanden)	(1 times)
Aalles	(Alles)	(1 times)
Aallle	(Alle)	(1 times)
Aals	(Als)	(1 times)
Aaresse	(Adresse)	(1 times)
Aauf	(Auf)	(3 times)
Aaus	(Aus)	(1 times)
Aause	(Hause)	(1 times)
Abar	(Aber)	(1 times)
Abbar	(Aber)	(1 times)
Abeit	(Arbeit)	(1 times)
Abes	(Aber)	(1 times)
Abgehelt	(abgeholt)	(1 times)
Absich	(Absicht)	(2 times)
Achtug	(Achtung)	(1 times)
Aderese	(Adresse)	(1 times)
Adrese	(Adresse)	(2 times)
Adrresse	(Adresse)	(1 times)
Ahha	(Aha)	(1 times)
Ales	(Alles)	(5 times)
Alles-	(Alles)	(1 times)
Angekomen	(angekommen)	(1 times)
Angruf	(Anruf)	(1 times)
Angts	(Angst)	(1 times)
Anrft	(Anruft)	(1 times)
Anrruft	(anruft)	(1 times)
Anru=f	(Anruf)	(2 times)
Anruhf	(Anruf)	(1 times)
Anschlißend	(Anschließend)	(2 times)
Antort	(Antwort)	(1 times)
Anuft	(anruft)	(1 times)
Aperat	(Apparat)	(1 times)
Arber	(Aber)	(1 times)
Aruf	(Anruf)	(1 times)
Auf-	(Auf)	(1 times)
Aufgole	(Aufgabe)	(1 times)
Aufhengen	(Aufhängen)	(1 times)
AugenbliK	(Augenblick)	(1 times)
Auser	(Außer)	(2 times)
Baggon	(Waggon)	(1 times)
Bahm	(Bahn)	(1 times)
Baken	(Backen)	(1 times)
Bbätter	(Blätter)	(1 times)
Befestiege	(Befestige)	(1 times)
Befor	(Bevor)	(2 times)
Beibe	(Beide)	(1 times)
Belln	(Bellen)	(1 times)
Besitzarin	(Besitzerin)	(1 times)
Besizer	(Besitzer)	(1 times)
Besizerin	(Besitzerin)	(1 times)
Bestimt	(Bestimmt)	(1 times)
Beu-tel	(Beutel)	(1 times)
Beurtel	(Beutel)	(1 times)
Bewestigte	(befestigte)	(1 times)
Bewoner	(Bewohner)	(1 times)
Bielder	(Bilder)	(1 times)
Bilt	(Bild)	(1 times)
Blakate	(Plakate)	(2 times)
Blider	(Bilder)	(1 times)
Blumenstraus	(Blumenstrauß)	(1 times)
Blumtöpfe	(Blumentöpfe)	(1 times)
Blutzlich	(Plötzlich)	(1 times)
Blädter	(Blätter)	(1 times)
Bläter	(Blätter)	(2 times)
Blötzlich	(Plötzlich)	(1 times)
Bobon	(Bonbon)	(1 times)
Boeutel	(Beutel)	(1 times)
Bonbong	(Bonbon)	(1 times)
Bonen	(Boden)	(1 times)
Brüo	(Büro)	(2 times)
Buhaltestelle	(Bushaltestelle)	(1 times)
Burgersteik	(Bürgersteig)	(1 times)
Burk	(Burg)	(11 times)
Burkersteik	(Bürgersteig)	(1 times)
Busfarher	(Busfahrer)	(1 times)
Busfuhrer	(Busfahrer)	(1 times)
Bushalltestelle	(Bushaltestelle)	(1 times)
Bushaltestehle	(Bushaltestelle)	(1 times)
Bushaltestele	(Bushaltestelle)	(1 times)
Bushaltesteler	(Bushaltestelle)	(1 times)
Bussfahrt	(Busfahrt)	(1 times)
Busshalltestelle	(Bushaltestelle)	(1 times)
Busshaltestelle	(Bushaltestelle)	(5 times)
Bäutel	(Beutel)	(9 times)
Daa	(Da)	(1 times)
Dabai	(Dabei)	(1 times)
Dabhei	(Dabei)	(1 times)
Dah	(Da)	(2 times)
Dakel	(Dackel)	(1 times)
Damme	(Dame)	(1 times)
Danachh	(Danach)	(1 times)
Danah	(Danach)	(2 times)
Danck	(Dank)	(1 times)
Dancke	(Danke)	(3 times)
Dann-	(Dann)	(1 times)
Dannach	(Danach)	(8 times)
Dannnach	(Danach)	(1 times)
Darbei	(Dabei)	(1 times)
DasWegen	(Deswegen)	(1 times)
Daswegen	(Deswegen)	(2 times)
Daw	(Da)	(1 times)
Dedeektive	(Detektive)	(1 times)
Dedybären	(Teddybären)	(1 times)
Deusch	(Deutsch)	(1 times)
Dierekt	(Direkt)	(1 times)
Dinstag	(Dienstag)	(1 times)
Diregt	(Direkt)	(1 times)
Docb	(Doch)	(1 times)
Donach	(Danach)	(1 times)
Donerstag	(Donnerstag)	(2 times)
Dooktor	(Doktor)	(1 times)
Dreckt	(Dreck)	(1 times)
Drek	(Dreck)	(1 times)
Drönte	(Dröhnte)	(1 times)
Dunach	(Danach)	(2 times)
Dunn	(Dann)	(2 times)
Echsplosohn	(Explosion)	(1 times)
Ecksplusiom	(Explosion)	(1 times)
Eeis	(Eis)	(12 times)
Eiemal	(Einmal)	(1 times)
Einkaufzentrum	(Einkaufszentrum)	(1 times)
Eisdile	(Eisdiele)	(2 times)
Eisi	(Eis)	(1 times)
Eistile	(Eisdiele)	(1 times)
Eke	(Ecke)	(2 times)
End	(Ende)	(1 times)
Endliech	(Endlich)	(1 times)
Endschuldigten	(entschuldigten)	(1 times)
Endschuldigung	(Entschuldigung)	(2 times)
Englich	(Endlich)	(1 times)
Entlich	(Endlich)	(2 times)
Entschuldiegung	(Entschuldigung)	(1 times)
Erdbere	(Erdbeere)	(2 times)
Ergebniss	(Ergebnis)	(1 times)
Erschroken	(Erschrocken)	(1 times)
Ersente	(ersehnte)	(1 times)
Expliosion	(Explosion)	(1 times)
Fedybären	(Teddybären)	(1 times)
Fehnster	(Fenster)	(3 times)
Fehrnsehen	(Fernsehen)	(1 times)
Fensder	(Fenster)	(1 times)
Fenser	(Fenster)	(1 times)
Fenskerbank	(Fensterbank)	(1 times)
Fenstbank	(Fensterbank)	(1 times)
Fenstehr	(Fenster)	(3 times)
Fenster-bank	(Fensterbank)	(1 times)
FensterRamen	(Fensterrahmen)	(1 times)
FensterSeiben	(Fensterscheiben)	(1 times)
Fensterbant	(Fensterbank)	(1 times)
Fensterbret	(Fensterbrett)	(1 times)
Fensterbund	(Fensterbank)	(1 times)
Fensterbunk	(Fensterbank)	(1 times)
Fensterhanck	(Fensterbank)	(1 times)
Fensterramen	(Fensterrahmen)	(6 times)
Fensterscheib	(Fensterscheibe)	(1 times)
Fensterscheile	(Fensterscheibe)	(1 times)
Fensterschreibe	(Fensterscheibe)	(1 times)
Fenstr	(Fenster)	(1 times)
Fenter	(Fenster)	(1 times)
Fenzter	(Fenster)	(3 times)
FenzterBank	(Fensterbank)	(1 times)
Fenzterscheibe	(Fensterscheibe)	(1 times)
Ferabschiedet	(verabschiedet)	(1 times)
Ferbredeten	(verabredeten)	(1 times)
Ferkeuver	(Verkäufer)	(1 times)
Ferkäufer	(Verkäufer)	(1 times)
Ferlorene	(Verlorene)	(1 times)
Fernster	(Fenster)	(2 times)
Ferschwunden	(Verschwunden)	(1 times)
Ferster	(Fenster)	(2 times)
Ferwundert	(Verwundert)	(1 times)
Fesntenerbank	(Fensterbank)	(1 times)
Fesnter	(Fenster)	(1 times)
Festerscheibe	(Fensterscheibe)	(1 times)
Fhenster	(Fenster)	(1 times)
Filler	(Füller)	(1 times)
Fkrau	(Frau)	(1 times)
Fnster	(Fenster)	(4 times)
Fogel	(Vogel)	(7 times)
Forosch	(Frosch)	(1 times)
Forsichtzhalber	(Vorsichtshalber)	(1 times)
Fotto	(Foto)	(1 times)
Frauf	(Frau)	(1 times)
Fraund	(Freund)	(1 times)
Frendin	(Freundin)	(1 times)
Freund's	(Freunds)	(1 times)
Freund,in	(Freundin)	(1 times)
Freundinen	(Freundinnen)	(1 times)
Freundinn	(Freundin)	(1 times)
Freunt	(Freund)	(5 times)
Frölich	(Fröhlich)	(3 times)
Frü	(Früh)	(1 times)
Früling	(Frühling)	(2 times)
Früstück	(Frühstück)	(1 times)
Fuau	(Frau)	(1 times)
Fuller	(Füller)	(3 times)
Fulr	(Flur)	(1 times)
Futer	(Futter)	(4 times)
Fänster	(Fenster)	(4 times)
Fötchen	(Pfötchen)	(1 times)
Füler	(Füller)	(4 times)
Fütter	(Futter)	(4 times)
Gechenk	(Geschenk)	(1 times)
Gechichte	(Geschichte)	(2 times)
Gecklingelt	(geklingelt)	(1 times)
Gehfühl	(Gefühl)	(1 times)
Gehfül	(Gefühl)	(1 times)
Gehtan	(getan)	(2 times)
Geiheim	(Geheim)	(1 times)
Gereusch	(Geräusch)	(2 times)
Gerlacht	(gelacht)	(1 times)
Geschaft	(Geschafft)	(2 times)
Geschefte	(Geschäfte)	(1 times)
Geschek	(Geschenk)	(1 times)
Geschen	(Geschenk)	(1 times)
Gescheng	(Geschenk)	(2 times)
Geschßent	(Geschenk)	(1 times)
Geschäftsman	(Geschäftsmann)	(1 times)
Gesichtausdrük	(Gesichtsausdruck)	(1 times)
Gesichtsausdruk	(Gesichtsausdruck)	(1 times)
Gesttern	(Gestern)	(1 times)
Gischichte	(Geschichte)	(1 times)
Gischichten	(Geschichten)	(1 times)
Glascheibe	(Glasscheibe)	(1 times)
Glasschärben	(Glasscherben)	(1 times)
Glüch	(Glück)	(1 times)
Glücklieste	(glücklichste)	(1 times)
Glük	(Glück)	(1 times)
Gäfegnis	(Gefängnis)	(1 times)
Halltestelle	(Haltestelle)	(1 times)
Halsban	(Halsband)	(1 times)
Halsbant	(Halsband)	(1 times)
Halskete	(Halskette)	(1 times)
Halteschtelle	(Haltestelle)	(1 times)
Haltestehle	(Haltestelle)	(1 times)
Haltestele	(Haltestelle)	(2 times)
Haltestell	(Haltestelle)	(1 times)
Haltsband	(Halsband)	(1 times)
Halzband	(Halsband)	(2 times)
Halzbant	(Halsband)	(1 times)
Happ	(Happy)	(2 times)
Harren	(Haaren)	(1 times)
Haupt-rollen	(Hauptrollen)	(1 times)
Hausabeid	(Hausarbeit)	(1 times)
Hausabeit	(Hausarbeit)	(1 times)
Hausarest	(Hausarrest)	(5 times)
Hauserest	(Hausarrest)	(2 times)
Hauserrest	(Hausarrest)	(4 times)
Hausofgaben	(Hausaufgaben)	(1 times)
Hautür	(Haustür)	(2 times)
Hendlar	(Händler)	(1 times)
Hendler	(Händler)	(1 times)
Herr.	(Herr)	(4 times)
Herrum	(herum)	(1 times)
Hingefalen	(hingefallen)	(1 times)
Hllo	(Hallo)	(1 times)
Hochker	(Hocker)	(1 times)
Hofnung	(Hoffnung)	(1 times)
Hofnwng	(Hoffnung)	(1 times)
Hoker	(Hocker)	(1 times)
HundeFuter	(Hundefutter)	(2 times)
Hundefter	(Hundefutter)	(1 times)
Hundefuder	(Hundefutter)	(1 times)
Hundefuter	(Hundefutter)	(6 times)
Hundefutte	(Hundefutter)	(1 times)
Hundefutter-	(Hundefutter)	(1 times)
Hundefütter	(Hundefutter)	(2 times)
Hunderfutter	(Hundefutter)	(1 times)
Hundevutech	(Hundefutter)	(1 times)
Hundfuter	(Hundefutter)	(1 times)
Hundfutter	(Hundefutter)	(2 times)
Hungei	(Hunger)	(1 times)
Hwndefwtter	(Hundefutter)	(1 times)
Händ	(Hand)	(1 times)
Idde	(Idee)	(4 times)
Ide	(Idee)	(4 times)
Inenstad	(Innenstadt)	(1 times)
Inochen	(Knochen)	(1 times)
Irgentetwas	(Irgendetwas)	(1 times)
Irgentwan	(Irgendwann)	(1 times)
Jake	(Jacke)	(31 times)
Jakke	(Jacke)	(2 times)
Jarke	(Jacke)	(1 times)
Jemahd	(Jemand)	(1 times)
Jemant	(Jemand)	(1 times)
Jetzt-	(Jetzt)	(1 times)
Jezt	(Jetzt)	(9 times)
Jeztt	(Jetzt)	(1 times)
Juhnge	(Junge)	(1 times)
Jurge	(Junge)	(1 times)
Kabbine	(Kabine)	(1 times)
Kaffe	(Kaffee)	(1 times)
Kakau	(Kakao)	(1 times)
Kaoton	(Karton)	(1 times)
Kaputgegangen	(kaputtgegangen)	(1 times)
Karbuttgegangen	(kaputtgegangen)	(1 times)
Kartchen	(Kärtchen)	(1 times)
Kartog	(Karton)	(2 times)
KartonK	(Karton)	(1 times)
Kartong	(Karton)	(52 times)
Kartongs	(Kartons)	(1 times)
Kartongt	(Karton)	(4 times)
Kartonk	(Karton)	(4 times)
Kartonks	(Kartons)	(1 times)
Kartorn	(Karton)	(1 times)
Katog	(Karton)	(6 times)
Katok	(Karton)	(1 times)
Katon	(Karton)	(25 times)
Katongs	(Kartons)	(1 times)
Kaze	(Katze)	(1 times)
Keckse	(Kekse)	(8 times)
Kegse	(Kekse)	(6 times)
Kekze	(Kekse)	(2 times)
Kertong	(Karton)	(1 times)
Kese	(Kekse)	(2 times)
Kete	(Kette)	(3 times)
Kiender	(Kinder)	(1 times)
Kieste	(Kiste)	(3 times)
Kihste	(Kiste)	(1 times)
Kilngelte	(klingelte)	(1 times)
Kimdern	(Kindern)	(1 times)
Kis=te	(Kiste)	(1 times)
Kisste	(Kiste)	(1 times)
Kiston	(Kisten)	(1 times)
Klassenkammeraden	(Klassenkameraden)	(1 times)
Klassenlererin	(Klassenlehrerin)	(1 times)
Klassenraumm	(Klassenraum)	(1 times)
Klassenszimmer	(Klassenzimmer)	(1 times)
Klassenzimer	(Klassenzimmer)	(1 times)
Klinelt	(Klingelt)	(1 times)
Klinelte	(klingelte)	(1 times)
Klingell	(Klingel)	(1 times)
Klingette	(klingelte)	(1 times)
Kmochen	(Knochen)	(1 times)
Kniee	(Knie)	(1 times)
Knoche	(Knochen)	(1 times)
Knochel	(Knochen)	(2 times)
Knochns	(Knochens)	(1 times)
Knoden	(Knoten)	(1 times)
Knohen	(Knochen)	(1 times)
Knuten	(Knoten)	(1 times)
Korper	(Körper)	(1 times)
Kpof	(Kopf)	(1 times)
Kummpel	(Kumpel)	(1 times)
Kurtz	(Kurz)	(3 times)
Lader	(Laden)	(1 times)
Langweiten	(langweilen)	(1 times)
Lechelnde	(lächelnde)	(1 times)
Leckali	(Leckerli)	(1 times)
Leckerlie	(Leckerli)	(5 times)
Leherin	(Lehrerin)	(12 times)
Leherrin	(Lehrerin)	(2 times)
Lehrarin	(Lehrerin)	(4 times)
Lehreerin	(Lehrerin)	(1 times)
Lehrehrin	(Lehrerin)	(2 times)
Lehreinnen	(Lehrerinnen)	(1 times)
Lehrelien	(Lehrerin)	(1 times)
Lehrenrhin	(Lehrerin)	(1 times)
Lehreren	(Lehrerin)	(3 times)
Lehrerien	(Lehrerin)	(2 times)
Lehrerine	(Lehrerin)	(1 times)
Lehrerinn	(Lehrerin)	(2 times)
Lehrerrin	(Lehrerin)	(1 times)
Lenerinnen	(Lehrerinnen)	(1 times)
Lerehrin	(Lehrerin)	(1 times)
Lererin	(Lehrerin)	(26 times)
Lererinen	(Lehrerinnen)	(1 times)
Lerherin	(Lehrerin)	(2 times)
Lerhrerin	(Lehrerin)	(2 times)
Lerrerien	(Lehrerin)	(1 times)
Lerrerin	(Lehrerin)	(2 times)
Leztem	(letztem)	(1 times)
Liblingsessen	(Lieblingsessen)	(1 times)
Lohrarin	(Lehrerin)	(1 times)
Losgehlassen	(losgelassen)	(1 times)
Losgelasen	(losgelassen)	(2 times)
MahteArbeit	(Mathearbeit)	(1 times)
MahteBuch	(Mathebuch)	(1 times)
Mamar	(Mama)	(1 times)
Mamtel	(Mantel)	(1 times)
Mantell	(Mantel)	(3 times)
Margen	(Magen)	(1 times)
Marmaladen	(Marmeladen)	(1 times)
Matamatig	(Mathematik)	(1 times)
Matematig	(Mathematik)	(2 times)
Matematik	(Mathematik)	(1 times)
Mathmatik	(Mathematik)	(1 times)
Mattel	(Mantel)	(1 times)
Mauar	(Mauer)	(2 times)
Mauea	(Mauer)	(1 times)
Mauer-	(Mauer)	(1 times)
Maur	(Mauer)	(1 times)
Minut	(Minute)	(1 times)
Minwten	(Minuten)	(1 times)
Misgeschick	(Missgeschick)	(1 times)
Mistgeschig	(Missgeschick)	(1 times)
Mitag	(Mittag)	(1 times)
MitargsSchlarf	(Mittagsschlaf)	(1 times)
Mitwoch	(Mittwoch)	(1 times)
Mnuten	(Minuten)	(1 times)
Motagmoren	(Montagmorgen)	(1 times)
Mrs.	(Mrs)	(1 times)
Mull'secke	(Müllsäcke)	(1 times)
Mulleimer	(Mülleimer)	(1 times)
Mundt	(Mund)	(1 times)
Mädchen's	(Mädchens)	(2 times)
Mädschen	(Mädchen)	(2 times)
Mätchen	(Mädchen)	(5 times)
Mäuer	(Mauer)	(3 times)
Möleimer	(Mülleimer)	(1 times)
Müleimer	(Mülleimer)	(6 times)
Mülleinmer	(Mülleimer)	(1 times)
Mülltone	(Mülltonne)	(7 times)
Mültone	(Mülltonne)	(1 times)
Nachbar-rin	(Nachbarin)	(1 times)
Nachbaren	(Nachbarin)	(1 times)
Nachbarien	(Nachbarin)	(1 times)
Nachbarrin	(Nachbarin)	(1 times)
Nachber	(Nachbar)	(6 times)
Nachberein	(Nachbarin)	(1 times)
Nachberim	(Nachbarin)	(1 times)
Nachberin	(Nachbarin)	(14 times)
Nachberinn	(Nachbarin)	(2 times)
Nachbern	(Nachbarn)	(2 times)
Nachberrin	(Nachbarin)	(6 times)
Nachberschafft	(Nachbarschaft)	(1 times)
Nacher	(Nachher)	(1 times)
Nachicht	(Nachricht)	(2 times)
Nachichten	(Nachrichten)	(1 times)
Nachmitag	(Nachmittag)	(4 times)
Nachmiterg	(Nachmittag)	(1 times)
Nachmitttag	(Nachmittag)	(1 times)
Nachtbar	(Nachbar)	(1 times)
Nartbarschaft	(Nachbarschaft)	(1 times)
Naturlich	(Natürlich)	(3 times)
Nrummer	(Nummer)	(1 times)
Numer	(Nummer)	(9 times)
Okey	(Okay)	(17 times)
Palkat	(Plakat)	(1 times)
Papkartonks	(Pappkartons)	(1 times)
Papkartons	(Pappkartons)	(1 times)
Parg	(Park)	(2 times)
Passiren	(passieren)	(2 times)
Passirte	(passierte)	(1 times)
PlaKarte	(Plakate)	(2 times)
Plackarte	(Plakate)	(1 times)
Plackat	(Plakat)	(3 times)
Plackate	(Plakate)	(13 times)
Plackaten	(Plakaten)	(2 times)
Plagate	(Plakate)	(1 times)
Plagkat	(Plakat)	(1 times)
Plaka	(Plakat)	(1 times)
Plakade	(Plakate)	(1 times)
Plakal	(Plakat)	(1 times)
Plakart	(Plakat)	(3 times)
Plakarte	(Plakate)	(15 times)
Plakarten	(Plakaten)	(2 times)
Plakartte	(Plakate)	(1 times)
Plakast	(Plakat)	(1 times)
Plakte	(Plakate)	(5 times)
Plareate	(Plakate)	(1 times)
Plarkard	(Plakat)	(1 times)
Plarkarte	(Plakate)	(1 times)
Plarkate	(Plakate)	(2 times)
Plockate	(Plakate)	(2 times)
Plotzlich	(Plötzlich)	(26 times)
Plotztlich	(Plötzlich)	(1 times)
Plozlich	(Plötzlich)	(2 times)
Plumste	(plumpste)	(1 times)
Pluzlich	(Plötzlich)	(1 times)
Plätzlich	(Plötzlich)	(1 times)
Plöchlich	(Plötzlich)	(1 times)
Plölich	(Plötzlich)	(3 times)
Plölzlich	(Plötzlich)	(4 times)
Plöslich	(Plötzlich)	(1 times)
Plötlich	(Plötzlich)	(2 times)
Plötslirch	(Plötzlich)	(1 times)
Plöttslich	(Plötzlich)	(1 times)
Plötzli	(Plötzlich)	(1 times)
Plötzlig	(Plötzlich)	(2 times)
Plötzlisch	(Plötzlich)	(1 times)
Plötztlich	(Plötzlich)	(1 times)
Plözich	(Plötzlich)	(1 times)
Plözlich	(Plötzlich)	(45 times)
Plöztich	(Plötzlich)	(1 times)
Plöztlch	(Plötzlich)	(1 times)
Plöztlich	(Plötzlich)	(4 times)
Poblem	(Problem)	(1 times)
Poliezei	(Polizei)	(1 times)
Poosters	(Posters)	(1 times)
Portuonen	(Portionen)	(1 times)
Pplatz	(Platz)	(1 times)
Prinsesin	(Prinzessin)	(1 times)
Pöltzlich	(Plötzlich)	(1 times)
Pölzlich	(Plötzlich)	(2 times)
Pötzlich	(Plötzlich)	(2 times)
Püramide	(Pyramide)	(1 times)
RUcksag	(Rucksack)	(1 times)
Ragete	(Rakete)	(1 times)
Rehschnet	(rechnet)	(1 times)
Reuber	(Räuber)	(1 times)
Rif	(Rief)	(1 times)
RuKsaK	(Rucksack)	(1 times)
Ruchsack	(Rucksack)	(4 times)
Ruckaack	(Rucksack)	(1 times)
Ruckcksack	(Rucksack)	(1 times)
Rucksach	(Rucksack)	(2 times)
Rucksag	(Rucksack)	(8 times)
Rucksagk	(Rucksack)	(4 times)
Rucksagt	(Rucksack)	(1 times)
Rucksak	(Rucksack)	(40 times)
Rucksasck	(Rucksack)	(1 times)
Rucksck	(Rucksack)	(1 times)
Rucksuch	(Rucksack)	(1 times)
Rucksuck	(Rucksack)	(2 times)
Rucktack	(Rucksack)	(1 times)
Ruhgsak	(Rucksack)	(3 times)
Rukesack	(Rucksack)	(1 times)
Ruksack	(Rucksack)	(3 times)
Ruksak	(Rucksack)	(12 times)
Rurksak	(Rucksack)	(1 times)
Räschnenaufgabe	(Rechenaufgabe)	(1 times)
SPaßirgang	(Spaziergang)	(1 times)
Sadwich	(Sandwich)	(1 times)
Sammstag	(Samstag)	(2 times)
Samsta	(Samstag)	(1 times)
Schdaubsauga	(Staubsauger)	(1 times)
Schielzeug	(Spielzeug)	(1 times)
Schlaffzimmer	(Schlafzimmer)	(1 times)
Schlekte	(schleckte)	(1 times)
Schlislich	(Schließlich)	(1 times)
Schmertz	(Schmerz)	(1 times)
Schmuts	(Schmutz)	(1 times)
Schnapen	(schnappen)	(1 times)
Schreiptisch	(Schreibtisch)	(1 times)
Schrek	(Schreck)	(1 times)
Schtaubsaugen	(Staubsauger)	(1 times)
Schtaubsauger	(Staubsauger)	(2 times)
Schtaupsauger	(Staubsauger)	(2 times)
Schubsauger	(Staubsauger)	(1 times)
SchuhlGlocke	(Schulglocke)	(1 times)
Schuhlhof	(Schulhof)	(1 times)
SchulTasch	(Schultasche)	(1 times)
Schulgebeude	(Schulgebäude)	(1 times)
Schulle	(Schule)	(4 times)
Schullfeg	(Schulweg)	(1 times)
Schullklasse	(Schulklasse)	(1 times)
Schulule	(Schule)	(1 times)
Schuweg	(Schulweg)	(1 times)
Schwantz	(Schwanz)	(1 times)
Schwinmen	(Schwimmen)	(1 times)
Schärben	(Scherben)	(1 times)
Schüs	(Tschüs)	(3 times)
Schüsel	(Schüssel)	(2 times)
Seill	(Seil)	(3 times)
Soforle	(Sofort)	(1 times)
Soger	(Sogar)	(1 times)
Sonigen	(sonnigen)	(1 times)
Sonniegen	(sonnigen)	(1 times)
Spacieren	(spazieren)	(1 times)
Spanung	(Spannung)	(1 times)
SparzirStok	(Spazierstock)	(1 times)
Sparziren	(spazieren)	(2 times)
Sparzirgang	(Spaziergang)	(1 times)
Spasirgan	(Spaziergang)	(1 times)
Spatzirgang	(Spaziergang)	(1 times)
Spazihren	(spazieren)	(1 times)
Spaziren	(spazieren)	(5 times)
Spazirengehen	(Spazierengehen)	(1 times)
Spazirgang	(Spaziergang)	(1 times)
Spielzeuk	(Spielzeug)	(2 times)
Spliter	(Splitter)	(1 times)
Stabsauger	(Staubsauger)	(1 times)
Staeub	(Staub)	(1 times)
Stain	(Stein)	(1 times)
Statd	(Stadt)	(6 times)
StauPsauger	(Staubsauger)	(2 times)
Staubsager	(Staubsauger)	(1 times)
Staubsauga	(Staubsauger)	(1 times)
Staubsaugen	(Staubsauger)	(1 times)
Staubsauger-	(Staubsauger)	(1 times)
Staubsaugrr	(Staubsauger)	(1 times)
Staubseuger	(Staubsauger)	(2 times)
Staudsauger	(Staubsauger)	(1 times)
Staugsauger	(Staubsauger)	(1 times)
Staupsauber	(Staubsauger)	(1 times)
Staupsauga	(Staubsauger)	(1 times)
Staupsauger	(Staubsauger)	(17 times)
Stauptsauga	(Staubsauger)	(1 times)
Stieft	(Stift)	(6 times)
Stifft	(Stift)	(1 times)
Stok	(Stock)	(1 times)
Stplitter	(Splitter)	(1 times)
Strorße	(Straße)	(1 times)
Stubsauger	(Staubsauger)	(1 times)
Stundnte	(Stunde)	(1 times)
T-sHrt	(T-Shirt)	(1 times)
T-shert	(T-Shirt)	(1 times)
Tadybär	(Teddybär)	(1 times)
Tadyybär	(Teddybär)	(1 times)
Tarzächlich	(Tatsächlich)	(1 times)
Tascle	(Tasche)	(1 times)
Tatsechlich	(Tatsächlich)	(1 times)
Teddi	(Teddy)	(12 times)
Teddibär	(Teddybär)	(2 times)
Teddie	(Teddy)	(1 times)
Teddy-Bär	(Teddybär)	(1 times)
Teddy-bär	(Teddybär)	(1 times)
TeddyBear	(Teddybär)	(1 times)
Teddybar	(Teddybär)	(2 times)
Teddybear	(Teddybär)	(6 times)
Teddyber	(Teddybär)	(3 times)
Teddyberen	(Teddybären)	(1 times)
Teddyybär	(Teddybär)	(1 times)
Tedibär	(Teddybär)	(5 times)
Tediebäre	(Teddybär)	(1 times)
Tediy	(Teddy)	(1 times)
Tedy	(Teddy)	(36 times)
TedyBär	(Teddybär)	(3 times)
Tedybear	(Teddybär)	(1 times)
Tedyber	(Teddybär)	(4 times)
Tedyberen	(Teddybären)	(1 times)
Tedybär	(Teddybär)	(25 times)
Tedybären	(Teddybären)	(1 times)
Tedyy	(Teddy)	(7 times)
TedyyBear	(Teddybär)	(1 times)
Tedyyberen	(Teddybären)	(1 times)
Teedi	(Teddy)	(1 times)
Teedy	(Teddy)	(2 times)
Tefefonnummer	(Telefonnummer)	(1 times)
Tehlefon	(Telefon)	(1 times)
Tehma	(Thema)	(1 times)
Teisch	(Teich)	(3 times)
Telefan	(Telefon)	(1 times)
Telefen	(Telefon)	(1 times)
Telefhonnummer	(Telefonnummer)	(1 times)
Telefohn	(Telefon)	(4 times)
Telefohnnummer	(Telefonnummer)	(1 times)
TelefonNumer	(Telefonnummer)	(1 times)
Telefonirten	(telefonierten)	(1 times)
Telefonn	(Telefon)	(1 times)
Telefonnumer	(Telefonnummer)	(15 times)
Telefonnumme	(Telefonnummer)	(1 times)
Telefonselle	(Telefonzelle)	(1 times)
Telefonumer	(Telefonnummer)	(3 times)
Telefonummern	(Telefonnummern)	(1 times)
Telefphon	(Telefon)	(1 times)
Telefun	(Telefon)	(2 times)
Telepfon	(Telefon)	(3 times)
Telephon	(Telefon)	(4 times)
Televon	(Telefon)	(3 times)
Telfon	(Telefon)	(1 times)
Telfonnummer	(Telefonnummer)	(1 times)
Tellefon	(Telefon)	(2 times)
Tellefonanumer	(Telefonnummer)	(1 times)
Tellefonn	(Telefon)	(1 times)
Tellefonnummer	(Telefonnummer)	(1 times)
Tellevon	(Telefon)	(1 times)
Telofan	(Telefon)	(1 times)
Telofon	(Telefon)	(3 times)
Telofonire	(telefoniere)	(1 times)
Telofonnume	(Telefonnummer)	(1 times)
Telofonnumer	(Telefonnummer)	(1 times)
Tenster	(Fenster)	(1 times)
Tensterbank	(Fensterbank)	(1 times)
Tiesch	(Tisch)	(1 times)
Tirartzt	(Tierarzt)	(1 times)
Tirarzt	(Tierarzt)	(1 times)
Tlefoen	(Telefon)	(1 times)
Tolette	(Toilette)	(1 times)
Tomatensohse	(Tomatensoße)	(1 times)
Traurich	(Traurig)	(1 times)
Trobfen	(Tropfen)	(1 times)
Trotztim	(Trotzdem)	(1 times)
Tschuss	(Tschüss)	(1 times)
Turmm	(Turm)	(4 times)
Täddy	(Teddy)	(2 times)
Tädyy	(Teddy)	(2 times)
Türm	(Turm)	(3 times)
U.bahn	(U-Bahn)	(1 times)
Uberaschung	(Überraschung)	(2 times)
Uberraschug	(Überraschung)	(1 times)
Uberraschung	(Überraschung)	(3 times)
Umamt	(umarmt)	(1 times)
Und-	(Und)	(1 times)
Undd	(Und)	(1 times)
Ungefär	(Ungefähr)	(1 times)
Unt	(Und)	(1 times)
Untericht	(Unterricht)	(8 times)
Unterischt	(Unterricht)	(1 times)
Unterrecht	(Unterricht)	(1 times)
Uogel	(Vogel)	(1 times)
VaneleEis	(Vanilleeis)	(1 times)
Vanile	(Vanille)	(1 times)
Vehrkauferin	(Verkäuferin)	(1 times)
Venster	(Fenster)	(1 times)
Verande	(Veranda)	(1 times)
Vergesener	(Vergessener)	(1 times)
Vermist	(Vermisst)	(2 times)
Verwurdert	(Verwundert)	(1 times)
Voge	(Vogel)	(2 times)
VogenL	(Vogel)	(1 times)
Voger	(Vogel)	(1 times)
Vogl	(Vogel)	(2 times)
Vor=	(Vor)	(1 times)
WIEDE	(WIEDER)	(1 times)
Wandt	(Wand)	(1 times)
Warheit	(Wahrheit)	(1 times)
Wasserfahl	(Wasserfall)	(1 times)
Weill	(Weil)	(3 times)
Werenddessen	(Währenddessen)	(1 times)
Wieleicht	(Vielleicht)	(1 times)
Wiesse	(Wiese)	(1 times)
Wilst	(Willst)	(1 times)
Wiso	(Wieso)	(2 times)
Wohnug	(Wohnung)	(1 times)
Wohnzemmer	(Wohnzimmer)	(1 times)
Wonung	(Wohnung)	(5 times)
Wonzimmer	(Wohnzimmer)	(1 times)
Wrosch	(Frosch)	(4 times)
Wärend	(Während)	(1 times)
Würklich	(Wirklich)	(1 times)
Würsichin	(Würstchen)	(1 times)
Yenau	(Genau)	(1 times)
Zetel	(Zettel)	(5 times)
Zimlick	(Ziemlich)	(1 times)
Zitrune	(Zitrone)	(1 times)
Zu-Hause	(Zuhause)	(1 times)
Zuletz	(Zuletzt)	(1 times)
Zusahmen	(Zusammen)	(1 times)
Zwichendursch	(Zwischendurch)	(1 times)
ab-gegeben	(abgegeben)	(1 times)
abar	(aber)	(1 times)
abber	(aber)	(2 times)
abchauen	(abhauen)	(1 times)
abdr	(aber)	(1 times)
abehaun	(abgehauen)	(1 times)
abeiten	(arbeiten)	(1 times)
abeiter	(Arbeiter)	(1 times)
abgefalen	(abgefallen)	(1 times)
abgehgangen	(abgegangen)	(1 times)
abgehgeben	(abgegeben)	(1 times)
abgehgehben	(abgegeben)	(1 times)
abgehold	(abgeholt)	(1 times)
abgehuen	(abgehauen)	(1 times)
abgennomen	(abgenommen)	(1 times)
abgenomen	(abgenommen)	(1 times)
abgeriesen	(abgerissen)	(1 times)
abgerisen	(abgerissen)	(1 times)
abgestürts	(abgestürzt)	(1 times)
abgipt	(abgibt)	(1 times)
abholln	(abholen)	(1 times)
abkrikt	(abkriegt)	(1 times)
abzubkomen	(abzubekommen)	(1 times)
aderes	(anderes)	(1 times)
adrese	(Adresse)	(5 times)
aegenzeitig	(gegenseitig)	(1 times)
aeinbicht	(einbricht)	(1 times)
ahngerufen	(angerufen)	(1 times)
ahnruft	(anruft)	(1 times)
aich	(auch)	(1 times)
aihr	(ihr)	(1 times)
ainer	(einer)	(1 times)
alein	(allein)	(3 times)
aleine	(alleine)	(7 times)
alerbester	(allerbester)	(1 times)
allle	(alle)	(1 times)
ameisten	(meisten)	(1 times)
amfang	(Anfang)	(1 times)
andaren	(anderen)	(2 times)
andre	(andere)	(3 times)
andren	(anderen)	(2 times)
andwort	(Antwort)	(2 times)
andwortet	(antwortet)	(2 times)
andwortete	(antwortete)	(1 times)
aneinnander	(aneinander)	(1 times)
aneruffen	(angerufen)	(1 times)
angeckomen	(angekommen)	(1 times)
angeckommen	(angekommen)	(1 times)
angekomen	(angekommen)	(9 times)
angeläschelt	(angelächelt)	(1 times)
angenomen	(angenommen)	(1 times)
angeommen	(angekommen)	(1 times)
angerand	(angerannt)	(3 times)
angerant	(angerannt)	(4 times)
angerifen	(angerufen)	(1 times)
angerofen	(angerufen)	(1 times)
angerrufen	(angerufen)	(1 times)
angerufen-	(angerufen)	(1 times)
angeruten	(angerufen)	(1 times)
angrannt	(angerannt)	(1 times)
angrufen	(angerufen)	(1 times)
angstwol	(angstvoll)	(1 times)
angärant	(angerannt)	(1 times)
anhilt	(anhielt)	(1 times)
ankahm	(ankam)	(1 times)
ankahmen	(ankamen)	(1 times)
ankamm	(ankam)	(1 times)
ankammen	(ankamen)	(1 times)
ankarm	(ankam)	(1 times)
ankekommen	(angekommen)	(1 times)
ankerufen	(angerufen)	(1 times)
annimst	(annimmst)	(1 times)
anrruf	(Anruf)	(1 times)
anruffen	(anrufen)	(1 times)
anruhf	(Anruf)	(2 times)
anruhft	(anruft)	(1 times)
anrut	(anruft)	(1 times)
anseige	(Anzeige)	(1 times)
antfortette	(antwortete)	(1 times)
anung	(Ahnung)	(4 times)
anungloss	(ahnungslos)	(1 times)
anwig	(anfing)	(1 times)
anwing	(anfing)	(1 times)
aper	(aber)	(2 times)
apgebildet	(abgebildet)	(2 times)
aphaut	(abhaut)	(1 times)
arber	(aber)	(2 times)
asu	(aus)	(1 times)
atwas	(etwas)	(1 times)
atwortete	(antwortete)	(1 times)
auch-	(auch)	(1 times)
auck	(auch)	(2 times)
auf-	(auf)	(2 times)
aufSchreiden	(aufschreiben)	(1 times)
auffrist	(auffrisst)	(1 times)
aufgade	(Aufgabe)	(1 times)
aufgebliben	(aufgeblieben)	(2 times)
aufgebract	(aufgebracht)	(1 times)
aufgefahlen	(aufgefallen)	(1 times)
aufgefahllen	(aufgefallen)	(1 times)
aufgeh.passt	(aufgepasst)	(1 times)
aufgehangt	(aufgehängt)	(1 times)
aufgehengt	(aufgehängt)	(9 times)
aufgehhengt	(aufgehängt)	(1 times)
aufgehhängt	(aufgehängt)	(1 times)
aufgehstanden	(aufgestanden)	(2 times)
aufgemachnd	(aufgemacht)	(1 times)
aufgemmacht	(aufgemacht)	(1 times)
aufgepast	(aufgepasst)	(3 times)
aufgerekt	(aufgeregt)	(2 times)
aufgereumt	(aufgeräumt)	(2 times)
aufgerisen	(aufgerissen)	(1 times)
aufgeschprungen	(aufgesprungen)	(1 times)
aufgeschriben	(aufgeschrieben)	(1 times)
aufgestahnden	(aufgestanden)	(1 times)
aufgestehlt	(aufgestellt)	(1 times)
aufgestelt	(aufgestellt)	(1 times)
aufhengen	(aufhängen)	(5 times)
aufpast	(aufpasst)	(2 times)
aufreumen	(aufräumen)	(3 times)
aufreumte	(aufräumte)	(1 times)
aufsuhalten	(aufzuhalten)	(1 times)
aufzuhengen	(aufzuhängen)	(5 times)
aufzumunter	(aufzumuntern)	(1 times)
aufzuschreilen	(aufzuschreiben)	(1 times)
aufzusteen	(aufzustehen)	(1 times)
augr	(Auge)	(1 times)
aus-	(aus)	(3 times)
ausbrobirt	(ausprobiert)	(1 times)
auser	(außer)	(6 times)
auserdem	(außerdem)	(1 times)
ausf	(auf)	(1 times)
ausgbrochen	(ausgebrochen)	(1 times)
ausgehstiegen	(ausgestiegen)	(1 times)
ausgelach	(ausgelacht)	(1 times)
ausgelachnd	(ausgelacht)	(2 times)
ausgelert	(ausgeleert)	(1 times)
ausgerunscht	(ausgerutscht)	(1 times)
ausgeruscht	(ausgerutscht)	(1 times)
ausgerut	(ausgeruht)	(1 times)
ausgerutcht	(ausgerutscht)	(2 times)
ausgeschtiegen	(ausgestiegen)	(1 times)
ausgesehn	(ausgesehen)	(1 times)
ausgesticken	(ausgestiegen)	(1 times)
ausgestieben	(ausgestiegen)	(1 times)
ausgestigen	(ausgestiegen)	(15 times)
ausgstigen	(ausgestiegen)	(2 times)
auslehren	(ausleeren)	(4 times)
ausleren	(ausleeren)	(11 times)
auslern	(ausleeren)	(4 times)
auslerren	(ausleeren)	(1 times)
auslerrgen	(ausleeren)	(1 times)
auslert	(ausleert)	(1 times)
ausnamsweise	(ausnahmsweise)	(1 times)
ausrichden	(ausrichten)	(1 times)
ausseigen	(aussteigen)	(1 times)
aussiet	(aussieht)	(1 times)
ausstaign	(aussteigen)	(1 times)
ausstgeigen	(aussteigen)	(1 times)
auszulern	(auszuleeren)	(2 times)
awf	(auf)	(3 times)
awfhengte	(aufhängte)	(1 times)
baar	(paar)	(1 times)
baber	(aber)	(1 times)
baei	(bei)	(1 times)
bauchscherzen	(Bauchschmerzen)	(1 times)
bauhen	(bauen)	(2 times)
bauwen	(bauen)	(1 times)
beailten	(beeilten)	(1 times)
becKommen	(bekommen)	(1 times)
becheftigt	(beschäftigt)	(1 times)
bechlosen	(beschlossen)	(1 times)
beckam	(bekam)	(7 times)
beckomme	(bekomme)	(2 times)
beckommen	(bekommen)	(3 times)
bedancken	(bedanken)	(1 times)
bedangte	(bedankte)	(1 times)
bedannkt	(bedankt)	(1 times)
beemerckt	(bemerkt)	(1 times)
befastigt	(befestigt)	(1 times)
befersdigen	(befestigen)	(1 times)
befesdigt	(befestigt)	(1 times)
befestickte	(befestigte)	(1 times)
befestiechte	(befestigte)	(1 times)
befestikt	(befestigt)	(1 times)
befestikte	(befestigte)	(1 times)
befestikten	(befestigten)	(1 times)
befor	(bevor)	(3 times)
befsigien	(befestigen)	(1 times)
befstigt	(befestigt)	(1 times)
befästigt	(befestigt)	(5 times)
begang	(begann)	(2 times)
beginnnen	(beginnen)	(1 times)
begonen	(begonnen)	(4 times)
begrußten	(begrüßten)	(1 times)
begrüsen	(begrüßen)	(1 times)
begrüst	(begrüßt)	(1 times)
begrüste	(begrüßte)	(1 times)
behahalte	(behalte)	(1 times)
behmerkt	(bemerkt)	(1 times)
behrührt	(berührt)	(1 times)
beilen	(beeilen)	(2 times)
beist	(beißt)	(1 times)
bekahm	(bekam)	(1 times)
bekamm	(bekam)	(5 times)
bekan	(bekam)	(1 times)
bekommm	(bekomm)	(1 times)
belht	(bellt)	(2 times)
bellkte	(bellte)	(1 times)
belst	(bellst)	(1 times)
beltt	(bellt)	(1 times)
beltte	(bellte)	(2 times)
bemekte	(bemerkte)	(1 times)
bemerckt	(bemerkt)	(2 times)
bemergen	(bemerken)	(1 times)
bemergt	(bemerkt)	(6 times)
bemmerkte	(bemerkte)	(1 times)
bemrkt	(bemerkt)	(1 times)
bemährkt	(bemerkt)	(1 times)
bemärgt	(bemerkt)	(1 times)
bendet	(beendet)	(1 times)
benk	(denk)	(1 times)
benomen	(benommen)	(1 times)
bereit's	(bereits)	(2 times)
bergüßte	(begrüßte)	(1 times)
berhalten	(behalten)	(1 times)
berllt	(bellt)	(1 times)
berüren	(berühren)	(1 times)
berürt	(berührt)	(1 times)
bescheftigt	(beschäftigt)	(1 times)
beschftigt	(beschäftigt)	(1 times)
beschlos	(beschloss)	(1 times)
beschlosen	(beschlossen)	(2 times)
beser	(besser)	(3 times)
besietzer	(Besitzer)	(1 times)
besorkt	(besorgt)	(1 times)
bestimt	(bestimmt)	(8 times)
beudel	(Beutel)	(1 times)
beultel	(Beutel)	(1 times)
beware	(bewahre)	(1 times)
bewaren	(bewahren)	(1 times)
bewekt	(bewegt)	(2 times)
bewogt	(bewegt)	(1 times)
bewoner	(Bewohner)	(1 times)
bewor	(bevor)	(1 times)
bezitzerin	(Besitzerin)	(1 times)
beängstigent	(beängstigend)	(1 times)
bicht	(bricht)	(1 times)
bie	(bei)	(3 times)
biei	(bei)	(1 times)
bield	(Bild)	(2 times)
bielder	(Bilder)	(1 times)
bies	(bis)	(6 times)
bieschen	(bisschen)	(1 times)
bischen	(bisschen)	(20 times)
bisitzerin	(Besitzerin)	(1 times)
bisshen	(bisschen)	(1 times)
bistimt	(bestimmt)	(2 times)
blakate	(Plakate)	(2 times)
bleb	(bleib)	(1 times)
bliken	(blicken)	(1 times)
bmerkte	(bemerkte)	(1 times)
boeutel	(Beutel)	(2 times)
bomboms	(Bonbons)	(1 times)
braune-	(braune)	(1 times)
brienge	(bringe)	(1 times)
briengt	(bringt)	(1 times)
brig	(bring)	(2 times)
brige	(bringe)	(2 times)
brigen	(bringen)	(1 times)
briingst	(bringst)	(1 times)
brink	(bring)	(1 times)
brinng	(bring)	(1 times)
brülen	(brüllen)	(1 times)
bs	(bis)	(1 times)
bscheftigt	(beschäftigt)	(1 times)
budeln	(buddeln)	(1 times)
buen	(bauen)	(1 times)
butel	(Beutel)	(1 times)
bäutel	(Beutel)	(1 times)
böre	(böse)	(1 times)
büse	(böse)	(1 times)
caufen	(kaufen)	(1 times)
chat	(hat)	(5 times)
chergelaufen	(hergelaufen)	(1 times)
chief	(schief)	(1 times)
chienter	(hinter)	(1 times)
ckiste	(Kiste)	(1 times)
cklingelte	(klingelte)	(1 times)
daabei	(dabei)	(1 times)
daan	(dann)	(3 times)
dabai	(dabei)	(1 times)
dabe	(dabei)	(1 times)
dabeie	(dabei)	(1 times)
dabeiy	(dabei)	(1 times)
dabel	(dabei)	(1 times)
dabie	(dabei)	(1 times)
dachde	(dachte)	(2 times)
dachin	(dahin)	(1 times)
dadchte	(dachte)	(1 times)
dadei	(dabei)	(1 times)
dadrien	(dadrin)	(1 times)
dadzu	(dazu)	(1 times)
dafon	(davon)	(10 times)
dagege	(dagegen)	(1 times)
dahte	(dachte)	(1 times)
dakechön	(dankeschön)	(1 times)
dakel	(Dackel)	(1 times)
daken	(danken)	(1 times)
dakeschön	(dankeschön)	(1 times)
damid	(damit)	(1 times)
dammit	(damit)	(1 times)
danah	(danach)	(1 times)
danch	(danach)	(2 times)
dancke	(danke)	(2 times)
daneden	(daneben)	(1 times)
daneeben	(daneben)	(1 times)
danelem	(daneben)	(1 times)
dangt	(dankt)	(1 times)
danit	(damit)	(1 times)
dankar	(dankbar)	(1 times)
dankeSchon	(dankeschön)	(1 times)
danker	(danke)	(1 times)
dannach	(danach)	(10 times)
dannke	(danke)	(2 times)
danoch	(danach)	(1 times)
daram	(daran)	(1 times)
darbei	(dabei)	(4 times)
darfür	(dafür)	(2 times)
darhin	(dahin)	(1 times)
darke	(danke)	(1 times)
darneben	(daneben)	(1 times)
daruber	(darüber)	(2 times)
daruf	(darauf)	(1 times)
darun	(daran)	(1 times)
darwm	(darum)	(1 times)
dasrauf	(darauf)	(1 times)
daswegen	(deswegen)	(6 times)
dauen	(bauen)	(1 times)
dauuste	(dauerte)	(1 times)
deann	(dann)	(1 times)
deas	(das)	(1 times)
dedankt	(bedankt)	(1 times)
degrüßen	(begrüßen)	(1 times)
dehsalb	(deshalb)	(1 times)
dei	(bei)	(5 times)
deide	(beide)	(1 times)
dellt	(bellt)	(1 times)
dem-	(dem)	(1 times)
demm	(dem)	(2 times)
dengt	(denkt)	(7 times)
denoch	(dennoch)	(1 times)
der-	(der)	(1 times)
derkekt	(direkt)	(1 times)
desaugt	(gesaugt)	(1 times)
deuldlih	(deutlich)	(1 times)
di	(da)	(1 times)
dic	(dich)	(1 times)
diech	(dich)	(3 times)
diee	(die)	(1 times)
dieken	(dicken)	(2 times)
dierekt	(direkt)	(2 times)
diesma	(diesmal)	(2 times)
dihr	(dir)	(2 times)
diken	(dicken)	(1 times)
direckt	(direkt)	(1 times)
diregt	(direkt)	(2 times)
dis	(bis)	(3 times)
disen	(diesen)	(7 times)
diser	(dieser)	(2 times)
dish	(dich)	(1 times)
dismal	(diesmal)	(1 times)
disses	(dieses)	(1 times)
dist	(bist)	(1 times)
dmait	(damit)	(1 times)
dmit	(damit)	(2 times)
dn	(an)	(2 times)
dnd	(und)	(1 times)
do	(da)	(5 times)
docch	(doch)	(1 times)
doden	(Boden)	(1 times)
doe	(die)	(1 times)
doff	(doof)	(1 times)
dol	(doll)	(8 times)
dole	(doll)	(2 times)
dooktor	(Doktor)	(1 times)
dord	(dort)	(2 times)
dorften	(durften)	(1 times)
dos	(das)	(1 times)
drane	(dran)	(3 times)
drarußen	(draußen)	(1 times)
draufen	(draußen)	(1 times)
draurig	(traurig)	(1 times)
drekig	(dreckig)	(3 times)
drekt	(direkt)	(2 times)
dring	(bring)	(1 times)
drinn	(drin)	(3 times)
drunte	(drunter)	(1 times)
drükt	(drückt)	(4 times)
duchs	(durchs)	(2 times)
duchte	(dachte)	(1 times)
duf	(auf)	(1 times)
dunke	(danke)	(1 times)
durschgedred	(durchgedreht)	(1 times)
dwrch	(durch)	(2 times)
dörfen	(dürfen)	(2 times)
düfen	(dürfen)	(1 times)
ebenfals	(ebenfalls)	(2 times)
ebensfals	(ebenfalls)	(1 times)
edwas	(etwas)	(1 times)
eemacht	(gemacht)	(1 times)
egarl	(egal)	(1 times)
eggal	(egal)	(1 times)
egsploson	(Explosion)	(1 times)
egstra	(extra)	(1 times)
eifach	(einfach)	(2 times)
eigenlich	(eigentlich)	(1 times)
eigentich	(eigentlich)	(1 times)
eimal	(einmal)	(17 times)
eimmal	(einmal)	(1 times)
ein-	(ein)	(2 times)
eineholt	(eingeholt)	(1 times)
einein	(einen)	(1 times)
eineir	(einer)	(1 times)
einerr	(einer)	(1 times)
einfahch	(einfach)	(1 times)
einfch-	(einfach)	(1 times)
einfehlt	(einfällt)	(1 times)
einferstanden	(einverstanden)	(1 times)
einffach	(einfach)	(1 times)
eingefalen	(eingefallen)	(1 times)
eingefannen	(eingefangen)	(1 times)
eingehollt	(eingeholt)	(1 times)
eingestigen	(eingestiegen)	(2 times)
einhollen	(einholen)	(3 times)
einkauftasch	(Einkaufstasche)	(1 times)
einmall	(einmal)	(11 times)
einmol	(einmal)	(1 times)
einn	(ein)	(1 times)
einnal	(einmal)	(1 times)
einnes	(Eines)	(1 times)
einruft	(anruft)	(2 times)
einwach	(einfach)	(1 times)
einzuSchlafe	(einzuschlafen)	(1 times)
eirem	(einem)	(1 times)
ekltra	(extra)	(1 times)
eksplodiert	(explodiert)	(1 times)
eksplodirt	(explodiert)	(1 times)
ekstra	(extra)	(1 times)
enach	(nach)	(1 times)
encklich	(endlich)	(1 times)
ende-	(Ende)	(1 times)
endeckt	(entdeckt)	(2 times)
endeckte	(entdeckte)	(2 times)
endschuldigen	(entschuldigen)	(1 times)
endschuldigte	(entschuldigte)	(1 times)
endschuldigten	(entschuldigten)	(2 times)
endschuldigung	(Entschuldigung)	(1 times)
endsparnt	(entspannt)	(1 times)
enem	(einem)	(2 times)
englich	(Endlich)	(1 times)
englich	(endlich)	(3 times)
enklich	(endlich)	(1 times)
enmal	(einmal)	(1 times)
enschuldigten	(entschuldigten)	(2 times)
enschuldikt	(entschuldigt)	(1 times)
enschultigte	(entschuldigte)	(1 times)
entdeken	(entdecken)	(1 times)
entdekt	(entdeckt)	(1 times)
enteckt	(entdeckt)	(1 times)
enteuscht	(enttäuscht)	(1 times)
entfrnte	(entfernte)	(1 times)
entgehgen	(entgegen)	(1 times)
entglich	(endlich)	(1 times)
entlich	(endlich)	(10 times)
entschuldikten	(entschuldigten)	(1 times)
entschuldrigten	(entschuldigten)	(1 times)
entsetst	(entsetzt)	(1 times)
entteucht	(enttäuscht)	(1 times)
entteuscht	(enttäuscht)	(1 times)
entzetz	(entsetzt)	(1 times)
entzuckt	(entzückt)	(1 times)
entäuscht	(enttäuscht)	(2 times)
eplodirt	(explodiert)	(1 times)
er-	(er)	(1 times)
eranstalten	(veranstalten)	(1 times)
erchaken	(erschraken)	(1 times)
erchreckt	(erschreckt)	(1 times)
erckleren	(erklären)	(1 times)
erdberEis	(Erdbeereis)	(1 times)
erdbere	(Erdbeere)	(1 times)
erfaht	(erfahrt)	(1 times)
erfaren	(erfahren)	(1 times)
ergendwo	(irgendwo)	(1 times)
ergentwohien	(irgendwohin)	(1 times)
ergerlich	(ärgerlich)	(1 times)
erkant	(erkannt)	(1 times)
erleischtert	(erleichtert)	(1 times)
erleistert	(erleichtert)	(1 times)
erlich	(ehrlich)	(1 times)
ersaunt	(erstaunt)	(1 times)
erschocken	(erschrocken)	(2 times)
erschrack	(erschrak)	(8 times)
erschrag	(erschrak)	(5 times)
erschrechkt	(erschreckt)	(1 times)
erschrekte	(erschreckte)	(4 times)
erschrekten	(erschreckten)	(3 times)
erschrokken	(erschrocken)	(1 times)
erschtaund	(erstaunt)	(1 times)
erschöft	(erschöpft)	(1 times)
ersehe	(Versehen)	(1 times)
ersehen	(Versehen)	(2 times)
ersmal	(erstmal)	(1 times)
erstcaunt	(erstaunt)	(1 times)
ertberEis	(Erdbeereis)	(1 times)
ervisch	(erwisch)	(1 times)
erwartungsfoll	(erwartungsvoll)	(1 times)
erwiederte	(erwiderte)	(1 times)
erwiedot	(erwidert)	(1 times)
erzahlt	(erzählt)	(1 times)
esstt	(esst)	(1 times)
etlang	(entlang)	(1 times)
etwos	(etwas)	(1 times)
explodirt	(explodiert)	(1 times)
exspplusirt	(explodiert)	(1 times)
fagt	(fangt)	(1 times)
fahrren	(fahren)	(1 times)
fann	(dann)	(1 times)
fant	(fand)	(3 times)
farabredet	(verabredet)	(1 times)
faren	(fahren)	(6 times)
farlorene	(verlorene)	(1 times)
farschwundene	(verschwundene)	(1 times)
farzeug	(Fahrzeug)	(1 times)
fastsinirt	(fasziniert)	(1 times)
feherapredet	(verabredet)	(2 times)
fehnsterbank	(Fensterbank)	(1 times)
fehrhindert	(verhindert)	(1 times)
fehrloren	(verloren)	(1 times)
fehstalten	(festhalten)	(1 times)
felgt	(fegt)	(1 times)
fensder	(Fenster)	(3 times)
fenser	(Fenster)	(1 times)
fenserbank	(Fensterbank)	(1 times)
fenserscheiben	(Fensterscheiben)	(1 times)
fenstehr	(Fenster)	(1 times)
fensterbang	(Fensterbank)	(1 times)
fenzter	(Fenster)	(3 times)
ferabschidet	(verabschiedet)	(1 times)
ferabschideten	(verabschiedeten)	(1 times)
feranstaltet	(veranstaltet)	(1 times)
ferapredeten	(verabredeten)	(1 times)
ferchwunden	(verschwunden)	(1 times)
ferfolgen	(verfolgen)	(1 times)
ferfolgt	(verfolgt)	(1 times)
ferfolgt-	(verfolgt)	(1 times)
ferfolkt	(verfolgt)	(1 times)
ferfängt	(verfängt)	(1 times)
fergaß	(vergaß)	(1 times)
fergensen	(vergessen)	(1 times)
fergesene	(vergessene)	(2 times)
fergessen	(vergessen)	(21 times)
fergisst	(vergisst)	(1 times)
ferhindern	(verhindern)	(1 times)
ferjagt	(verjagt)	(1 times)
ferkeufer	(Verkäufer)	(1 times)
ferknotete	(verknotete)	(1 times)
ferkricht	(verkriecht)	(1 times)
ferletzt	(verletzt)	(3 times)
ferlohren	(verloren)	(1 times)
ferloren	(verloren)	(18 times)
ferlorende	(verlorene)	(1 times)
ferlorene	(verlorene)	(5 times)
ferlätzt	(verletzt)	(1 times)
fermisst	(vermisst)	(1 times)
ferscheuchen	(verscheuchen)	(1 times)
ferscheucht	(verscheucht)	(1 times)
ferschwand	(verschwand)	(3 times)
ferschwant	(verschwand)	(1 times)
ferschwuden	(verschwunden)	(1 times)
ferschwunden	(verschwunden)	(20 times)
ferschwundene	(verschwundene)	(3 times)
ferschüttet	(verschüttet)	(3 times)
ferspochen	(versprochen)	(1 times)
fersst	(fresst)	(1 times)
fersteckt	(versteckt)	(9 times)
fersteckte	(versteckte)	(2 times)
ferstehen	(verstehen)	(2 times)
ferstehkt	(versteckt)	(2 times)
ferstekt	(versteckt)	(4 times)
ferstektas	(verstecktes)	(1 times)
ferstekte	(versteckte)	(1 times)
ferstekten	(versteckten)	(1 times)
fersuch	(Versuch)	(1 times)
fersucht	(versucht)	(24 times)
fersuchte	(versuchte)	(3 times)
fersuchten	(versuchten)	(1 times)
fersuncken	(versunken)	(1 times)
fersweifelt	(verzweifelt)	(1 times)
fertich	(fertig)	(3 times)
fertieft	(vertieft)	(1 times)
fertik	(fertig)	(2 times)
fertrau	(Vertrau)	(1 times)
ferzeihen	(verzeihen)	(1 times)
ferzweifelt	(verzweifelt)	(2 times)
feshalten	(festhalten)	(1 times)
festalten	(festhalten)	(1 times)
festgehllten	(festgehalten)	(1 times)
festgemach	(festgemacht)	(1 times)
fhenster	(Fenster)	(1 times)
fidet	(findet)	(1 times)
fieleicht	(vielleicht)	(2 times)
fiell	(fiel)	(1 times)
fiendet	(findet)	(2 times)
firft	(wirft)	(1 times)
fliggt	(fliegt)	(1 times)
fligt	(fliegt)	(14 times)
flizt	(flitzt)	(1 times)
flok	(flog)	(1 times)
fogel	(Vogel)	(7 times)
fohrbeikommen	(vorbeikommen)	(1 times)
folkt	(folgt)	(3 times)
fom	(vom)	(13 times)
fon	(von)	(59 times)
forbei	(vorbei)	(10 times)
forbeikommen	(vorbeikommen)	(1 times)
forderbeine	(Vorderbeine)	(1 times)
forsichtich	(vorsichtig)	(1 times)
forsichtig	(vorsichtig)	(5 times)
forsichtik	(vorsichtig)	(1 times)
fosichtig	(vorsichtig)	(1 times)
fote	(Pfote)	(10 times)
foten	(Pfoten)	(3 times)
frakt	(fragt)	(1 times)
frakte	(fragte)	(2 times)
fraragte	(fragte)	(1 times)
freigehlasen	(freigelassen)	(1 times)
freunglich	(freundlich)	(1 times)
freunten	(freuten)	(1 times)
freute-	(freute)	(1 times)
freüte	(freute)	(1 times)
frirt	(friert)	(1 times)
fris	(friss)	(2 times)
fro	(froh)	(23 times)
froeunde	(Freunde)	(2 times)
frohlich	(fröhlich)	(5 times)
froho	(froh)	(1 times)
frout	(freut)	(1 times)
frude	(Freude)	(1 times)
fröchlich	(fröhlich)	(1 times)
fröhlig	(fröhlich)	(1 times)
fröhliger	(fröhlicher)	(1 times)
frölich	(fröhlich)	(50 times)
fröliches	(fröhliches)	(1 times)
frölichkeit	(Fröhlichkeit)	(1 times)
frü	(früh)	(1 times)
früen	(frühen)	(1 times)
früer	(früher)	(1 times)
frühlich	(fröhlich)	(2 times)
frülhoch	(fröhlich)	(1 times)
funkistonirt	(funktioniert)	(1 times)
fur	(fuhr)	(3 times)
futert	(futtert)	(1 times)
futerte	(futterte)	(1 times)
fußgangerzone	(Fußgängerzone)	(1 times)
fwr	(für)	(1 times)
fäht	(fährt)	(1 times)
fält	(fällt)	(22 times)
fänkt	(fängt)	(1 times)
färht	(fährt)	(1 times)
färletzt	(verletzt)	(1 times)
fästgebunden	(festgebunden)	(1 times)
fötchen	(Pfötchen)	(4 times)
füchterlich	(fürchterlich)	(1 times)
fühen	(frühen)	(1 times)
füler	(Füller)	(4 times)
fürsterlich	(fürchterlich)	(1 times)
gad	(gab)	(1 times)
gahb	(gab)	(3 times)
gahsi	(Gassi)	(1 times)
gane	(ganz)	(1 times)
ganse	(ganze)	(7 times)
gansen	(ganzen)	(1 times)
gantz	(ganz)	(6 times)
gantze	(ganze)	(2 times)
gantzen	(ganzen)	(1 times)
ganzt	(ganz)	(1 times)
ganß	(ganz)	(1 times)
gap	(gab)	(2 times)
garade	(gerade)	(1 times)
garb	(gab)	(1 times)
gaze	(ganze)	(1 times)
gbracht	(gebracht)	(1 times)
gdacht	(gedacht)	(1 times)
geStolpat	(gestolpert)	(1 times)
geagt	(gejagt)	(1 times)
gebleben	(geblieben)	(1 times)
gebliben	(geblieben)	(3 times)
gebrach	(gebracht)	(4 times)
gebrül	(Gebrüll)	(1 times)
gebrült	(gebrüllt)	(1 times)
geburstag	(Geburtstag)	(2 times)
gebutstag	(Geburtstag)	(1 times)
gechapt	(gehabt)	(1 times)
gechen	(gehen)	(3 times)
gechenk	(Geschenk)	(1 times)
gechprungen	(gesprungen)	(1 times)
gechört	(gehört)	(1 times)
geckauft	(gekauft)	(2 times)
gecklaut	(geklaut)	(1 times)
gecknalt	(geknallt)	(1 times)
geckomen	(gekommen)	(4 times)
geckommen	(gekommen)	(3 times)
geckratz	(gekratzt)	(1 times)
geden	(geben)	(2 times)
gedrükt	(gedrückt)	(1 times)
geduldigt	(geduldig)	(1 times)
geemacht	(gemacht)	(1 times)
geessen	(gegessen)	(1 times)
gef=unden	(gefunden)	(1 times)
gefalen	(gefallen)	(50 times)
gefanen	(gefangen)	(1 times)
gefange	(gefangen)	(1 times)
gefaren	(gefahren)	(4 times)
gefast	(gefasst)	(1 times)
geffalen	(gefallen)	(3 times)
geffallen	(gefallen)	(1 times)
geffangen	(gefangen)	(1 times)
geffunden	(gefunden)	(1 times)
gefohnden	(gefunden)	(1 times)
gefolkt	(gefolgt)	(2 times)
gefonden	(gefunden)	(1 times)
geforden	(geworden)	(1 times)
geforfen	(geworfen)	(4 times)
gefrag	(gefragt)	(1 times)
gefrat	(gefragt)	(1 times)
gefresen	(gefressen)	(3 times)
gefreud	(gefreut)	(5 times)
gefreunnt	(gefreut)	(1 times)
gefrout	(gefreut)	(1 times)
gefrut	(gefreut)	(1 times)
gefuden	(gefunden)	(3 times)
gefuhnden	(gefunden)	(1 times)
gefunde	(gefunden)	(3 times)
gefunen	(gefunden)	(3 times)
gefunten	(gefunden)	(1 times)
gefönden	(gefunden)	(1 times)
gefül	(Gefühl)	(3 times)
gegagan	(gegangen)	(1 times)
gegagen	(gegangen)	(3 times)
gegahngen	(gegangen)	(1 times)
geganden	(gegangen)	(1 times)
geganen	(gegangen)	(9 times)
gegange	(gegangen)	(3 times)
geganngen	(gegangen)	(1 times)
gegeden	(gegeben)	(1 times)
gegegesen	(gegessen)	(1 times)
gegeneinanda	(gegeneinander)	(1 times)
gegiben	(gegeben)	(1 times)
gegkommen	(gekommen)	(1 times)
geglaupt	(geglaubt)	(1 times)
geglingelnd	(geklingelt)	(1 times)
geglingelt	(geklingelt)	(1 times)
geglospft	(geklopft)	(1 times)
gegngen	(gegangen)	(2 times)
gegongen	(gegangen)	(1 times)
gegracht	(gebracht)	(1 times)
gehabd	(gehabt)	(1 times)
gehabrt	(gehabt)	(1 times)
gehbaut	(gebaut)	(1 times)
gehben	(Geben)	(1 times)
gehbliben	(geblieben)	(1 times)
gehbracht	(gebracht)	(1 times)
gehdacht	(gedacht)	(1 times)
gehefalen	(gefallen)	(2 times)
gehefangen	(gefangen)	(1 times)
gehen-	(gehen)	(1 times)
gehfalen	(gefallen)	(1 times)
gehfallen	(gefallen)	(1 times)
gehfunden	(gefunden)	(2 times)
gehfärlch	(gefährlich)	(1 times)
gehgahngen	(gegangen)	(1 times)
gehgangehn	(gegangen)	(1 times)
gehgangen	(gegangen)	(9 times)
gehgehn	(gegen)	(1 times)
gehhabt	(gehabt)	(1 times)
gehholt	(geholt)	(1 times)
gehhört	(gehört)	(1 times)
gehin	(gehen)	(1 times)
gehjagt	(gejagt)	(1 times)
gehkommen	(gekommen)	(1 times)
gehlacht	(gelacht)	(2 times)
gehlaufen	(gelaufen)	(3 times)
gehmacht	(gemacht)	(3 times)
gehnohmen	(genommen)	(1 times)
gehocht	(gehockt)	(1 times)
gehold	(geholt)	(1 times)
gehoschen	(gehorchen)	(1 times)
gehrade	(gerade)	(2 times)
gehsagt	(gesagt)	(4 times)
gehsaugt	(gesaugt)	(1 times)
gehsehen	(gesehen)	(14 times)
gehstorben	(gestorben)	(1 times)
gehtan	(getan)	(2 times)
gehttropft	(getropft)	(1 times)
gehzogehn	(gezogen)	(1 times)
gehzogen	(gezogen)	(1 times)
gehän	(gehen)	(1 times)
gehüft	(gehüpft)	(1 times)
geisth	(Geist)	(1 times)
gekichat	(gekichert)	(2 times)
gekilinelt	(geklingelt)	(1 times)
gekischert	(gekichert)	(1 times)
geklept	(geklebt)	(1 times)
geklingeld	(geklingelt)	(2 times)
geklinget	(geklingelt)	(1 times)
geklingetlt	(geklingelt)	(1 times)
geklinkelt	(geklingelt)	(1 times)
gekloft	(geklopft)	(1 times)
gekloppft	(geklopft)	(1 times)
geknalt	(geknallt)	(2 times)
gekomen	(gekommen)	(10 times)
gekommem	(gekommen)	(1 times)
gekommmen	(gekommen)	(1 times)
gekrabelt	(gekrabbelt)	(4 times)
gekrieht	(gekriegt)	(1 times)
gekriekt	(gekriegt)	(1 times)
gekrigt	(gekriegt)	(6 times)
gekringelt	(geklingelt)	(1 times)
gekuchelt	(gekuschelt)	(1 times)
gelach	(gelacht)	(1 times)
gelaht	(gelacht)	(2 times)
gelanded	(gelandet)	(3 times)
gelanet	(gelandet)	(1 times)
gelanweilt	(gelangweilt)	(1 times)
gelaufe	(gelaufen)	(1 times)
gelauven	(gelaufen)	(2 times)
gelechelt	(gelächelt)	(1 times)
gelechilt	(gelächelt)	(1 times)
geleichzeitich	(gleichzeitig)	(1 times)
geleufen	(gelaufen)	(1 times)
gelihen	(geliehen)	(1 times)
gellacht	(gelacht)	(2 times)
gelmben	(gelben)	(1 times)
gelöcklich	(glücklich)	(1 times)
gemaht	(gemacht)	(2 times)
gemaldet	(gemeldet)	(1 times)
gemeinsan	(gemeinsam)	(1 times)
gemeisam	(gemeinsam)	(1 times)
gemeldt	(gemeldet)	(1 times)
gemerckt	(gemerkt)	(4 times)
gemergt	(gemerkt)	(1 times)
gemert	(gemerkt)	(1 times)
gemracht	(gebracht)	(1 times)
gemuglich	(gemütlich)	(1 times)
gemutlich	(gemütlich)	(1 times)
generft	(genervt)	(1 times)
genhen	(gehen)	(1 times)
genomen	(genommen)	(39 times)
genuk	(genug)	(1 times)
genüslich	(genüsslich)	(1 times)
gepfifen	(gepfiffen)	(1 times)
gerad	(gerade)	(2 times)
gerada	(gerade)	(1 times)
gerant	(gerannt)	(18 times)
gerauschen	(Geräuschen)	(1 times)
gerchen	(gerochen)	(1 times)
gerechnete	(gerechnet)	(1 times)
gerechnit	(gerechnet)	(1 times)
gereded	(geredet)	(1 times)
gereusch	(Geräusch)	(4 times)
gerisen	(gerissen)	(3 times)
gerissin	(gerissen)	(1 times)
gerit	(geriet)	(1 times)
gerohen	(gerochen)	(2 times)
gerruch	(Geruch)	(1 times)
geruchen	(gerochen)	(1 times)
gerutcht	(gerutscht)	(1 times)
geruttscht	(gerutscht)	(1 times)
gesaagt	(gesagt)	(2 times)
gesag	(gesagt)	(3 times)
gesaght	(gesagt)	(1 times)
gesahgt	(gesagt)	(1 times)
gesaht	(gesagt)	(1 times)
gesasgt	(gesagt)	(1 times)
gesat	(gesagt)	(2 times)
gesaupt	(gesaugt)	(1 times)
gescha	(geschah)	(2 times)
geschaft	(geschafft)	(22 times)
geschar	(geschah)	(1 times)
geschek	(Geschenk)	(1 times)
gescheng	(Geschenk)	(1 times)
geschengt	(geschenkt)	(2 times)
geschikt	(geschickt)	(1 times)
geschikten	(geschickten)	(1 times)
geschimft	(geschimpft)	(1 times)
geschischte	(Geschichte)	(1 times)
geschmekt	(geschmeckt)	(1 times)
geschmisen	(geschmissen)	(1 times)
geschmizen	(geschmissen)	(1 times)
geschmolsen	(geschmolzen)	(1 times)
geschnapt	(geschnappt)	(4 times)
geschnkt	(geschenkt)	(1 times)
geschnupert	(geschnuppert)	(2 times)
geschokt	(geschockt)	(3 times)
geschriben	(geschrieben)	(6 times)
geschrihen	(geschrien)	(2 times)
geschrin	(geschrien)	(3 times)
geschtolpert	(gestolpert)	(3 times)
geschwindikeit	(Geschwindigkeit)	(1 times)
geschänk	(Geschenk)	(1 times)
geschümpft	(geschimpft)	(1 times)
gesechen	(gesehen)	(2 times)
gesehe	(gesehen)	(1 times)
gesehon	(gesehen)	(1 times)
gesgt	(gesagt)	(1 times)
gesich	(Gesicht)	(1 times)
gespant	(gespannt)	(6 times)
gespante	(gespannte)	(1 times)
gesperugen	(gesprungen)	(1 times)
gespiel	(gespielt)	(2 times)
gespild	(gespielt)	(1 times)
gespilt	(gespielt)	(1 times)
gesprongen	(gesprungen)	(1 times)
gesprun.gen	(gesprungen)	(1 times)
gesprungn	(gesprungen)	(1 times)
gespungen	(gesprungen)	(1 times)
gessagt	(gesagt)	(1 times)
gesscheng	(Geschenk)	(1 times)
gessehen	(gesehen)	(2 times)
gestekt	(gesteckt)	(2 times)
gestoben	(gestorben)	(2 times)
gestolPat	(gestolpert)	(1 times)
gestolbart	(gestolpert)	(1 times)
gestolbert	(gestolpert)	(1 times)
gestolpat	(gestolpert)	(2 times)
gestolper	(gestolpert)	(1 times)
gestosen	(gestoßen)	(1 times)
gestroben	(gestorben)	(1 times)
gesturmt	(gestürmt)	(1 times)
gesuchd	(gesucht)	(1 times)
getahn	(getan)	(4 times)
getauert	(gedauert)	(1 times)
geteielt	(geteilt)	(1 times)
geteit	(geteilt)	(1 times)
gethan	(getan)	(1 times)
getriten	(getreten)	(1 times)
getrofen	(getroffen)	(10 times)
getroft	(getropft)	(1 times)
getruken	(getrunken)	(1 times)
gettrofen	(getroffen)	(1 times)
gevallen	(gefallen)	(1 times)
gevorfen	(geworfen)	(1 times)
gewackeld	(gewackelt)	(1 times)
gewakelt	(gewackelt)	(2 times)
gewangen	(gefangen)	(1 times)
geweind	(geweint)	(1 times)
gewese	(gewesen)	(1 times)
geworffen	(geworfen)	(2 times)
gewuncken	(gewunken)	(2 times)
gewunderd	(gewundert)	(1 times)
gewust	(gewusst)	(1 times)
gezaigt	(gezeigt)	(1 times)
gezoge	(gezogen)	(1 times)
gezoggen	(gezogen)	(1 times)
geährliche	(gefährliche)	(1 times)
geöfnet	(geöffnet)	(2 times)
geöfnetes	(geöffnetes)	(1 times)
gfunden	(gefunden)	(4 times)
ghebt	(gebt)	(1 times)
ghen	(gehen)	(2 times)
gieben	(geben)	(1 times)
gieng	(ging)	(2 times)
giengen	(gingen)	(2 times)
gigessen	(gegessen)	(2 times)
gihng	(ging)	(1 times)
gim	(gib)	(1 times)
gink	(ging)	(1 times)
ginken	(gingen)	(1 times)
ginng	(ging)	(1 times)
gipt	(gibt)	(11 times)
glacklich	(glücklich)	(1 times)
glaich	(gleich)	(1 times)
glaiech	(gleich)	(1 times)
gleisch	(gleich)	(2 times)
glingelt	(klingelt)	(2 times)
glingelte	(klingelte)	(1 times)
gloklich	(glücklich)	(1 times)
gluKlich	(glücklich)	(2 times)
gluchlich	(glücklich)	(2 times)
glucklich	(glücklich)	(12 times)
gluklich	(glücklich)	(6 times)
glüKlich	(glücklich)	(1 times)
glüchklich	(glücklich)	(1 times)
glüchlich	(glücklich)	(1 times)
glücklic	(glücklich)	(1 times)
glücklicn	(glücklich)	(1 times)
glücklig	(glücklich)	(4 times)
glücklisch	(glücklich)	(1 times)
glüglich	(glücklich)	(18 times)
glügliches	(glückliches)	(1 times)
glük	(Glück)	(3 times)
glükclich	(glücklich)	(1 times)
glüklch	(glücklich)	(2 times)
glüklich	(glücklich)	(54 times)
glüklicher	(glücklicher)	(1 times)
glükliech	(glücklich)	(1 times)
glüklieg	(glücklich)	(1 times)
glüklisch	(glücklich)	(1 times)
gnz	(ganz)	(1 times)
goschichto	(Geschichte)	(1 times)
gracht	(kracht)	(1 times)
grgern	(ärgern)	(1 times)
grieg	(krieg)	(1 times)
griegst	(kriegst)	(1 times)
griegt	(kriegt)	(1 times)
grin	(drin)	(1 times)
grochen	(gerochen)	(1 times)
grücken	(drücken)	(1 times)
grücklich	(glücklich)	(1 times)
gsagt	(gesagt)	(1 times)
gtröstet	(getröstet)	(1 times)
guab	(gab)	(1 times)
gucgt	(guckt)	(1 times)
gud	(gut)	(1 times)
gugckt	(guckt)	(3 times)
gugkt	(guckt)	(2 times)
gukc	(guck)	(1 times)
gukt	(guckt)	(8 times)
gukte	(guckte)	(3 times)
gulücklich	(glücklich)	(1 times)
gäfehrlich	(gefährlich)	(2 times)
göhört	(gehört)	(1 times)
gönau	(genau)	(1 times)
gücklich	(glücklich)	(1 times)
gülücklich	(glücklich)	(1 times)
habent	(haben)	(1 times)
haber	(aber)	(1 times)
haeimlich	(heimlich)	(1 times)
hag	(hab)	(1 times)
halde	(halbe)	(1 times)
hale	(habe)	(4 times)
halen	(haben)	(1 times)
halsban	(Halsband)	(1 times)
halsbant	(Halsband)	(2 times)
haltan	(halten)	(1 times)
halteStäle	(Haltestelle)	(1 times)
haltehelle	(Haltestelle)	(1 times)
haltestele	(Haltestelle)	(2 times)
haltsband	(Halsband)	(1 times)
halzBand	(Halsband)	(1 times)
halzKete	(Halskette)	(1 times)
halzband	(Halsband)	(2 times)
halzbant	(Halsband)	(1 times)
hankam	(ankam)	(1 times)
hap	(hab)	(5 times)
hapen	(haben)	(1 times)
harbe	(habe)	(2 times)
hastich	(hastig)	(1 times)
hatetn	(hatten)	(1 times)
haubtsach	(Hauptsache)	(1 times)
hausabeit	(Hausarbeit)	(1 times)
hausarest	(Hausarrest)	(4 times)
hauserest	(Hausarrest)	(1 times)
hauserrest	(Hausarrest)	(2 times)
hausnumer	(Hausnummer)	(1 times)
haustur	(Haustür)	(1 times)
hecktisch	(hektisch)	(1 times)
hehr	(her)	(1 times)
heimlisch	(heimlich)	(1 times)
heiputzutage	(heutzutage)	(1 times)
heltet	(haltet)	(1 times)
hemand	(jemand)	(1 times)
henrunter	(herunter)	(1 times)
henterher	(hinterher)	(1 times)
hepy	(happy)	(1 times)
herfor	(hervor)	(5 times)
hernab	(herab)	(1 times)
herraus	(heraus)	(15 times)
herrausgefunden	(herausgefunden)	(1 times)
herrauskam	(herauskam)	(1 times)
herrein	(herein)	(7 times)
herrgelaufen	(hergelaufen)	(1 times)
herrum	(herum)	(1 times)
herrunder	(herunter)	(2 times)
herrunter	(herunter)	(2 times)
heruter	(herunter)	(1 times)
hholo	(hallo)	(1 times)
hieher	(hierher)	(1 times)
hiehterhier	(hinterher)	(1 times)
hield	(hielt)	(1 times)
hienderheer	(hinterher)	(1 times)
hieng	(hing)	(2 times)
hiensetzen	(hinsetzen)	(2 times)
hienter	(hinter)	(4 times)
hienterher	(hinterher)	(7 times)
hienunter	(hinunter)	(1 times)
hienüber	(hinüber)	(1 times)
hihlt	(hielt)	(1 times)
hihr	(hier)	(1 times)
hihrher	(hierher)	(1 times)
hinain	(hinein)	(1 times)
hinderher	(hinterher)	(1 times)
hingefalen	(hingefallen)	(5 times)
hingesellt	(hingestellt)	(1 times)
hingesezt	(hingesetzt)	(3 times)
hingestehlt	(hingestellt)	(1 times)
hingestelt	(hingestellt)	(8 times)
hingezetzt	(hingesetzt)	(1 times)
hinggefallen	(hingefallen)	(1 times)
hinn	(hin)	(2 times)
hinnsetzen	(hinsetzen)	(2 times)
hinnterher	(hinterher)	(1 times)
hinser	(hinter)	(1 times)
hinsetsen	(hinsetzen)	(5 times)
hinterbeinwe	(Hinterbeine)	(1 times)
hinterheher	(hinterher)	(1 times)
hinterhir	(hinterher)	(1 times)
hirher	(hierher)	(3 times)
hirhin	(hierhin)	(3 times)
hitfe	(Hilfe)	(1 times)
hnterher	(hinterher)	(1 times)
hochgehobem	(hochgehoben)	(1 times)
hofentLich	(hoffentlich)	(1 times)
hofentlich	(Hoffentlich)	(1 times)
hofentlich	(hoffentlich)	(3 times)
hoffentliel	(hoffentlich)	(1 times)
hoffnug	(Hoffnung)	(1 times)
hofnung	(Hoffnung)	(6 times)
hoft	(hofft)	(4 times)
honzentriert	(konzentriert)	(1 times)
hosee	(Hose)	(1 times)
ht	(hat)	(7 times)
hta	(hat)	(2 times)
htte	(hatte)	(1 times)
hunde-	(Hunde)	(1 times)
hundefuter	(Hundefutter)	(3 times)
hundelein	(Hundeleine)	(1 times)
hungel	(Hunger)	(1 times)
hungrich	(hungrig)	(1 times)
hungrieg	(hungrig)	(1 times)
hunrig	(hungrig)	(6 times)
häftigen	(heftigen)	(1 times)
hählt	(hält)	(1 times)
hät	(hat)	(1 times)
höcher	(höher)	(1 times)
hübft	(hüpft)	(1 times)
hübpft	(hüpft)	(1 times)
ichren	(ihren)	(1 times)
idde	(Idee)	(4 times)
iehr	(ihr)	(1 times)
iehre	(ihre)	(1 times)
iergentwas	(irgendwas)	(1 times)
ihnsehtzen	(hinsetzen)	(1 times)
ihnüber	(hinüber)	(1 times)
ihrgendwo	(irgendwo)	(1 times)
ihrgentein	(irgendein)	(1 times)
ihrgentwann	(irgendwann)	(1 times)
ihrgentwas	(irgendwas)	(1 times)
ihrgentwo	(irgendwo)	(1 times)
iht	(ihm)	(1 times)
im-	(im)	(1 times)
imarmt	(umarmt)	(1 times)
in-	(in)	(1 times)
indere	(andere)	(1 times)
inenStahd	(Innenstadt)	(1 times)
ins-	(ins)	(1 times)
interesant	(interessant)	(2 times)
inuber	(hinüber)	(1 times)
inzwichen	(inzwischen)	(1 times)
ire	(ihre)	(16 times)
irem	(ihrem)	(11 times)
iren	(ihren)	(25 times)
irer	(ihrer)	(5 times)
irgendtwo	(irgendwo)	(1 times)
irgendwan	(irgendwann)	(1 times)
irgentetwas	(irgendetwas)	(2 times)
irgentwan	(irgendwann)	(2 times)
irgentwas	(irgendwas)	(3 times)
irgentwi	(irgendwie)	(1 times)
irgentwie	(irgendwie)	(1 times)
irgentwohin	(irgendwohin)	(2 times)
irhe	(ihre)	(2 times)
irhen	(ihren)	(4 times)
ish	(ich)	(2 times)
istn	(ist)	(1 times)
istt	(isst)	(2 times)
ißst	(isst)	(1 times)
jedam	(jedem)	(1 times)
jemaand	(jemand)	(1 times)
jemad	(jemand)	(3 times)
jemal	(jemals)	(1 times)
jemamd	(jemand)	(1 times)
jeman	(jemand)	(4 times)
jemana	(jemand)	(1 times)
jemang	(jemand)	(1 times)
jemannd	(jemand)	(2 times)
jemant	(jemand)	(10 times)
jemmand	(jemand)	(3 times)
jetztt	(jetzt)	(1 times)
jezt	(jetzt)	(11 times)
juges	(junges)	(1 times)
k.no	(Kino)	(1 times)
kaachte	(krachte)	(1 times)
kabiene	(Kabine)	(2 times)
kabutgeganen	(kaputtgegangen)	(1 times)
kaeiner	(keiner)	(1 times)
kainer	(keiner)	(1 times)
kammen	(kamen)	(11 times)
kanz	(ganz)	(1 times)
kapirt	(kapiert)	(1 times)
kappunt	(kaputt)	(1 times)
kapput	(kaputt)	(9 times)
kapputgeht	(kaputtgeht)	(1 times)
kapputt	(kaputt)	(1 times)
kapputte	(kaputte)	(1 times)
kapurt	(kaputt)	(1 times)
kaput	(kaputt)	(88 times)
kaputem	(kaputtem)	(1 times)
kaputen	(kaputten)	(3 times)
kaputer	(kaputter)	(1 times)
kaputes	(kaputtes)	(1 times)
kaputgegagan	(kaputtgegangen)	(1 times)
kaputgegahngen	(kaputtgegangen)	(1 times)
kaputgegangen	(kaputtgegangen)	(9 times)
kaputgeganngen	(kaputtgegangen)	(1 times)
kaputgehgangen	(kaputtgegangen)	(2 times)
kaputgeht	(kaputtgeht)	(1 times)
kaputgemach	(kaputtgemacht)	(1 times)
kaputgemacht	(kaputtgemacht)	(1 times)
kaputmachen	(kaputtmachen)	(1 times)
karn	(kann)	(1 times)
kartog	(Karton)	(2 times)
kartong	(Karton)	(25 times)
kartongs	(Kartons)	(1 times)
kartonk	(Karton)	(1 times)
kartorn	(Karton)	(1 times)
katon	(Karton)	(11 times)
katongs	(Kartons)	(1 times)
keckse	(Kekse)	(7 times)
kefloken	(geflogen)	(1 times)
kehen	(gehen)	(1 times)
keinner	(keiner)	(1 times)
keksse	(Kekse)	(1 times)
kiendern	(Kindern)	(1 times)
kiksen	(Keksen)	(1 times)
kilingelt	(klingelt)	(1 times)
kingelt	(klingelt)	(1 times)
kinglte	(klingelte)	(1 times)
kipst	(kippst)	(1 times)
kipt	(kippt)	(1 times)
kischert	(kichert)	(1 times)
kister	(Kiste)	(1 times)
kizelt	(kitzelt)	(1 times)
kla	(klar)	(3 times)
klassenzimer	(Klassenzimmer)	(1 times)
kleinigkei	(Kleinigkeit)	(1 times)
klengelt	(klingelt)	(2 times)
klept	(klebt)	(2 times)
klepte	(klebte)	(1 times)
kletern	(klettern)	(1 times)
kletert	(klettert)	(6 times)
kleterte	(kletterte)	(1 times)
klibt	(klebt)	(1 times)
kliegel	(klingel)	(1 times)
kliegelt	(klingelt)	(1 times)
klienelt	(klingelt)	(1 times)
kliengeln	(klingeln)	(1 times)
kliengelt	(klingelt)	(4 times)
kliengelte	(klingelte)	(2 times)
kligelt	(klingelt)	(9 times)
kligelte	(klingelte)	(3 times)
klinelt	(klingelt)	(1 times)
klingehlt	(klingelt)	(1 times)
klingette	(klingelte)	(1 times)
klinngelte	(klingelte)	(1 times)
klngelt	(klingelt)	(1 times)
klobfte	(klopfte)	(1 times)
kloft	(klopft)	(1 times)
kläfte	(kläffte)	(2 times)
klözen	(Klötzen)	(1 times)
knaltte	(knallte)	(1 times)
knap	(knapp)	(1 times)
knikt	(knickt)	(2 times)
knochenn	(Knochen)	(1 times)
knochn	(Knochen)	(1 times)
knottet	(knotet)	(1 times)
kobf	(Kopf)	(1 times)
kogel	(Kugel)	(1 times)
kolen	(holen)	(1 times)
komich	(komisch)	(2 times)
kommaen	(kommen)	(1 times)
komomt	(kommt)	(1 times)
konmen	(kommen)	(1 times)
konnter	(konnte)	(1 times)
konntrole	(Kontrolle)	(1 times)
konntte	(konnte)	(1 times)
konsentrirt	(konzentriert)	(1 times)
kontet	(knotet)	(1 times)
kontrolierte	(kontrollierte)	(1 times)
kontte	(konnte)	(1 times)
konzendriert	(konzentriert)	(1 times)
konzentrirt	(konzentriert)	(1 times)
konzetrierte	(konzentrierte)	(1 times)
kopft	(klopft)	(1 times)
korton	(Karton)	(1 times)
kpput	(kaputt)	(1 times)
krabeln	(krabbeln)	(2 times)
krabelt	(krabbelt)	(4 times)
krabelte	(krabbelte)	(2 times)
krahelte	(krabbelte)	(1 times)
krakelt	(krabbelt)	(1 times)
kreftig	(kräftig)	(3 times)
kreftigen	(kräftigen)	(1 times)
kreisst	(kreist)	(1 times)
kreuzug	(Kreuzung)	(1 times)
kriekst	(kriegst)	(1 times)
kriekt	(kriegt)	(1 times)
krig	(krieg)	(2 times)
krigen	(kriegen)	(7 times)
krigst	(kriegst)	(2 times)
krigt	(kriegt)	(12 times)
krigte	(kriegte)	(1 times)
krigten	(kriegten)	(1 times)
kulerte	(kullerte)	(1 times)
kulerten	(kullerten)	(1 times)
kurser	(kurzer)	(1 times)
kurtz	(kurz)	(1 times)
kurtze	(kurze)	(1 times)
köntest	(könntest)	(2 times)
kürz	(kurz)	(1 times)
lachelte	(lächelte)	(1 times)
laehte	(lachte)	(1 times)
lagsam	(langsam)	(1 times)
lahen	(lachen)	(3 times)
lahend	(lachend)	(1 times)
laht	(lacht)	(1 times)
lahte	(lachte)	(1 times)
lamgsam	(langsam)	(2 times)
landette	(landete)	(1 times)
langsamm	(langsam)	(1 times)
langsum	(langsam)	(1 times)
langweilich	(langweilig)	(2 times)
lanweilig	(langweilig)	(2 times)
lechelndem	(lächelndem)	(1 times)
leckts	(leckt)	(1 times)
leherin	(Lehrerin)	(2 times)
lekeren	(leckeren)	(1 times)
lekommen	(bekommen)	(1 times)
lellen	(bellen)	(1 times)
lepten	(lebten)	(1 times)
lererin	(Lehrerin)	(8 times)
lererrin	(Lehrerin)	(1 times)
lerken	(lecken)	(1 times)
leufst	(läufst)	(1 times)
liber	(lieber)	(2 times)
liblingsessen	(Lieblingsessen)	(2 times)
liblingstessen	(Lieblingsessen)	(1 times)
liedt	(liebt)	(1 times)
liefehn	(liefen)	(1 times)
liencks	(links)	(1 times)
lienks	(links)	(2 times)
lif	(lief)	(4 times)
loker	(locker)	(2 times)
lokerer	(lockerer)	(1 times)
losGerisen	(losgerissen)	(1 times)
losfur	(losfuhr)	(1 times)
losgefaren	(losgefahren)	(1 times)
losgehlasen	(losgelassen)	(1 times)
losgelasen	(losgelassen)	(12 times)
losgellasen	(losgelassen)	(1 times)
losgerant	(losgerannt)	(1 times)
loskelasen	(losgelassen)	(1 times)
loslasen	(loslassen)	(3 times)
lossgelasen	(losgelassen)	(1 times)
lossgelassen	(losgelassen)	(1 times)
lost,läst	(loslässt)	(1 times)
lächerte	(lächelte)	(1 times)
löchelt	(lächelt)	(1 times)
machmal	(manchmal)	(1 times)
machnn	(machen)	(1 times)
machsts	(machst)	(1 times)
machts	(machst)	(1 times)
maein	(mein)	(1 times)
mahen	(machen)	(2 times)
maht	(macht)	(4 times)
matel	(Mantel)	(2 times)
mauar	(Mauer)	(1 times)
medchen	(Mädchen)	(1 times)
mehar	(mehr)	(1 times)
mehere	(mehrere)	(1 times)
mehrkte	(merkte)	(1 times)
meinzt	(meinst)	(1 times)
mekert	(meckert)	(1 times)
mercken	(merken)	(1 times)
merckt	(merkt)	(3 times)
merckte	(merkte)	(1 times)
merckten	(merkten)	(1 times)
mergt	(merkt)	(5 times)
mergt-	(merkt)	(1 times)
merkien	(merken)	(1 times)
merkwodigen	(merkwürdigen)	(1 times)
merr	(mehr)	(3 times)
meue	(neue)	(1 times)
mistferstendlis	(Missverständnis)	(1 times)
mitanander	(miteinander)	(1 times)
mitarbeita	(Mitarbeiter)	(1 times)
mitbeckamm	(mitbekam)	(1 times)
mitbeckommen	(mitbekommen)	(1 times)
mite	(mit)	(1 times)
miternander	(miteinander)	(1 times)
mitgbracht	(mitgebracht)	(1 times)
mitgebacht	(mitgebracht)	(1 times)
mitgebraht	(mitgebracht)	(2 times)
mitgebrart	(mitgebracht)	(1 times)
mitgebrht	(mitgebracht)	(1 times)
mitgehnommen	(mitgenommen)	(1 times)
mitgenomen	(mitgenommen)	(11 times)
mitgnomen	(mitgenommen)	(1 times)
mitleit	(Mitleid)	(1 times)
mitnemen	(mitnehmen)	(8 times)
momend	(Moment)	(2 times)
momeng	(Moment)	(1 times)
morgents	(morgens)	(1 times)
mouer	(Mauer)	(1 times)
munn	(Mann)	(1 times)
murmelete	(murmelte)	(1 times)
mussde	(musste)	(1 times)
mäcchen	(Mädchen)	(1 times)
mädschen	(Mädchen)	(1 times)
mähr	(mehr)	(1 times)
mögliech	(möglich)	(1 times)
mörkt	(merkt)	(1 times)
mülaeimer	(Mülleimer)	(1 times)
müleimer	(Mülleimer)	(2 times)
mülleimmer	(Mülleimer)	(1 times)
müstest	(müsstest)	(1 times)
nabf	(Napf)	(1 times)
nac	(nach)	(6 times)
nachba	(Nachbar)	(1 times)
nachberin	(Nachbarin)	(7 times)
nachicht	(Nachricht)	(1 times)
nachmitag	(Nachmittag)	(2 times)
nachrich	(Nachricht)	(1 times)
nachste	(nächste)	(1 times)
nachsten	(nächsten)	(3 times)
nachtbar	(Nachbar)	(2 times)
nadürlich	(natürlich)	(1 times)
nalütlich	(natürlich)	(1 times)
namlich	(nämlich)	(2 times)
nardürlich	(natürlich)	(2 times)
narmens	(namens)	(1 times)
narturlich	(natürlich)	(2 times)
nartürlich	(Natürlich)	(1 times)
nartürlisch	(natürlich)	(1 times)
natrüchlich	(natürlich)	(2 times)
natulich	(natürlich)	(2 times)
naturlich	(natürlich)	(1 times)
natörlich	(natürlich)	(1 times)
natülich	(natürlich)	(1 times)
natürlig	(natürlich)	(1 times)
nebeneinnander	(nebeneinander)	(1 times)
nechme	(nehme)	(1 times)
nechmen	(nehmen)	(1 times)
nechsten	(nächsten)	(1 times)
nehbehn	(neben)	(1 times)
nehben	(neben)	(3 times)
nehmmen	(nehmen)	(1 times)
nem	(dem)	(1 times)
neme	(nehme)	(1 times)
nemmen	(nehmen)	(1 times)
nemt	(nehmt)	(6 times)
nerfig	(nervig)	(1 times)
neteste	(netteste)	(1 times)
neugierg	(neugierig)	(1 times)
neugirig	(neugierig)	(3 times)
nevös	(nervös)	(1 times)
niccht	(nicht)	(1 times)
nicht's	(nichts)	(1 times)
nicht-	(nicht)	(1 times)
nichtt	(nicht)	(1 times)
niecht	(nicht)	(3 times)
niehmant	(niemand)	(1 times)
nieht	(nicht)	(2 times)
nieman	(niemand)	(2 times)
niemant	(niemand)	(1 times)
nimalz	(niemals)	(1 times)
nimand	(niemand)	(4 times)
nimant	(niemand)	(2 times)
nimlich	(nämlich)	(1 times)
nimmant	(niemand)	(1 times)
nimmich	(nämlich)	(1 times)
nirgenswo	(nirgendwo)	(2 times)
nochmall	(nochmal)	(4 times)
nonoch	(noch)	(1 times)
nooh	(noch)	(1 times)
notfal	(Notfall)	(1 times)
nr	(er)	(1 times)
numens	(namens)	(1 times)
numer	(Nummer)	(12 times)
nurkemzwo	(nirgendwo)	(1 times)
nähmlich	(nämlich)	(3 times)
nänlich	(nämlich)	(1 times)
nätürlich	(natürlich)	(2 times)
oKey	(okay)	(1 times)
ober	(aber)	(2 times)
obwoll	(obwohl)	(2 times)
okey	(Okay)	(4 times)
okey	(okay)	(13 times)
oky	(okay)	(1 times)
olso	(also)	(1 times)
omarmt	(umarmt)	(1 times)
omb	(ob)	(1 times)
op	(ob)	(5 times)
ortnung	(Ordnung)	(1 times)
ou	(du)	(1 times)
oub	(ob)	(1 times)
paeinlich	(peinlich)	(1 times)
panig	(Panik)	(1 times)
parr	(paar)	(3 times)
passiren	(passieren)	(3 times)
passirt	(passiert)	(11 times)
passirte	(passierte)	(1 times)
paty	(Party)	(1 times)
pflutscht	(flutscht)	(1 times)
piestole	(Pistole)	(1 times)
plackate	(Plakate)	(8 times)
plakarse	(Plakate)	(1 times)
plakart	(Plakat)	(1 times)
plakarte	(Plakate)	(7 times)
plakarten	(Plakaten)	(1 times)
plakatte	(Plakate)	(2 times)
plarkarte	(Plakate)	(1 times)
plesiert	(passiert)	(1 times)
plitchnass	(klitschnass)	(1 times)
plotzlich	(plötzlich)	(10 times)
plumste	(plumpste)	(2 times)
plöchlich	(plötzlich)	(1 times)
plölich	(plötzlich)	(2 times)
plölzlich	(plötzlich)	(1 times)
plötlich	(plötzlich)	(1 times)
plötslich	(plötzlich)	(2 times)
plötzlch	(plötzlich)	(1 times)
plötzli	(plötzlich)	(1 times)
plötzlin	(plötzlich)	(1 times)
plötztlich	(plötzlich)	(1 times)
plözlich	(plötzlich)	(16 times)
plözliech	(plötzlich)	(1 times)
plöztlich	(plötzlich)	(1 times)
poblem	(Problem)	(1 times)
priwat	(privat)	(1 times)
pötzlich	(plötzlich)	(1 times)
püber	(rüber)	(1 times)
raante	(rannte)	(1 times)
rahn	(ran)	(1 times)
rakette	(Rakete)	(1 times)
ralsgegommen	(rausgekommen)	(1 times)
rausgegommen	(rausgekommen)	(1 times)
rausgehgangen	(rausgegangen)	(1 times)
rausgehkommen	(rausgekommen)	(1 times)
rausgehold	(rausgeholt)	(1 times)
rausgekomen	(rausgekommen)	(2 times)
raws	(raus)	(1 times)
rchdig	(richtig)	(1 times)
reberieren	(reparieren)	(1 times)
rechent	(rechnet)	(1 times)
rechete	(rechnete)	(1 times)
rechnetete	(rechnete)	(1 times)
rechtseitisch	(rechtzeitig)	(1 times)
redem	(jedem)	(1 times)
reingekomen	(reingekommen)	(1 times)
reingelasen	(reingelassen)	(1 times)
reingenangen	(reingegangen)	(1 times)
reinn	(rein)	(1 times)
reinzuKomen	(reinzukommen)	(1 times)
rendt	(rennt)	(1 times)
renenen	(rennen)	(1 times)
rentt	(rennt)	(1 times)
rhr	(ihr)	(1 times)
richdig	(richtig)	(1 times)
richdik	(richtig)	(1 times)
rischtung	(Richtung)	(1 times)
rkatzete	(kratzte)	(1 times)
rous	(raus)	(1 times)
ruat	(ruft)	(1 times)
ruber	(rüber)	(1 times)
rucksag	(Rucksack)	(4 times)
rucksak	(Rucksack)	(10 times)
rucksok	(Rucksack)	(1 times)
ruig	(ruhig)	(1 times)
ruihg	(ruhig)	(1 times)
ruksack	(Rucksack)	(2 times)
ruksak	(Rucksack)	(6 times)
rumlauen	(rumlaufen)	(1 times)
rumtergefalen	(runtergefallen)	(1 times)
rundergefalen	(runtergefallen)	(3 times)
rundergefallen	(runtergefallen)	(1 times)
runtagefahlen	(runtergefallen)	(1 times)
runtagefalen	(runtergefallen)	(1 times)
runtagefallen	(runtergefallen)	(1 times)
runtar	(runter)	(1 times)
runterfalen	(runterfallen)	(1 times)
runtergefalen	(runtergefallen)	(12 times)
runtergeffallen	(runtergefallen)	(1 times)
runtergehfalen	(runtergefallen)	(1 times)
rutch	(rutsch)	(1 times)
rutchen	(rutschen)	(1 times)
rutcht	(rutscht)	(1 times)
rutchte	(rutschte)	(1 times)
rutergefalen	(runtergefallen)	(2 times)
rutschich	(rutschig)	(1 times)
ruut	(ruft)	(1 times)
rweil	(weil)	(1 times)
rübar	(rüber)	(1 times)
rübber	(rüber)	(1 times)
rübehr	(rüber)	(1 times)
rünter	(runter)	(1 times)
sPasieren	(spazieren)	(1 times)
saagte	(sagte)	(1 times)
saein	(sein)	(1 times)
sagten-	(sagten)	(1 times)
sahgte	(sagte)	(2 times)
sain	(sein)	(1 times)
sameln	(sammeln)	(1 times)
samelt	(sammelt)	(1 times)
sann	(dann)	(1 times)
sargt	(sagt)	(3 times)
sargte	(sagte)	(1 times)
sarß	(saß)	(1 times)
saubsauger	(Staubsauger)	(1 times)
sauerrei	(Sauerei)	(1 times)
schaniere	(Scharniere)	(1 times)
schdaupsauger	(Staubsauger)	(2 times)
schell	(schnell)	(3 times)
schenckte	(schenkte)	(1 times)
schengte	(schenkte)	(1 times)
schicherheit	(Sicherheit)	(1 times)
schif	(schief)	(3 times)
schik	(schick)	(2 times)
schiken	(schicken)	(1 times)
schikt	(schickt)	(1 times)
schimft	(schimpft)	(2 times)
schleunigs	(schleunigst)	(2 times)
schlim	(schlimm)	(1 times)
schlimes	(schlimmes)	(1 times)
schlislich	(schließlich)	(1 times)
schllechter	(schlechter)	(1 times)
schlukt	(schluckt)	(1 times)
schläfschen	(Schläfchen)	(1 times)
schlübft	(schlüpft)	(2 times)
schmeise	(schmeiße)	(1 times)
schmeisen	(schmeißen)	(6 times)
schmeist	(schmeißt)	(4 times)
schmeizt	(schmeißt)	(1 times)
schmeken	(schmecken)	(1 times)
schmekt	(schmeckt)	(1 times)
schmeterten	(schmetterten)	(1 times)
schmiltzt	(schmilzt)	(1 times)
schmugelt	(schmuggelt)	(1 times)
schmutsig	(schmutzig)	(1 times)
schmuzig	(schmutzig)	(2 times)
schmuzik	(schmutzig)	(1 times)
schnapen	(schnappen)	(3 times)
schnapt	(schnappt)	(2 times)
schneL	(schnell)	(1 times)
schneel	(schnell)	(1 times)
schnel	(schnell)	(59 times)
schneler	(schneller)	(11 times)
schnkt	(schenkt)	(1 times)
schnuperte	(schnupperte)	(1 times)
schnüfelte	(schnüffelte)	(1 times)
schnüwelt	(schnüffelt)	(1 times)
schockiet	(schockiert)	(1 times)
schockirt	(schockiert)	(1 times)
schocklade	(Schokolade)	(1 times)
schohn	(schon)	(2 times)
schokolarde	(Schokolade)	(1 times)
schonkte	(schenkte)	(1 times)
schonn	(schon)	(6 times)
schop	(schob)	(1 times)
schrebtisch	(Schreibtisch)	(1 times)
schreglich	(schrecklich)	(1 times)
schreiltisch	(Schreibtisch)	(1 times)
schreklich	(schrecklich)	(1 times)
schretblisch	(Schreibtisch)	(1 times)
schrieh	(schrie)	(3 times)
schrotplaz	(Schrottplatz)	(1 times)
schräkliche	(schreckliche)	(1 times)
schtaubsauger	(Staubsauger)	(1 times)
schuchtern	(schüchtern)	(1 times)
schulgloe	(Schulglocke)	(1 times)
schun	(schon)	(2 times)
schwerigkeiten	(Schwierigkeiten)	(1 times)
schänken	(schenken)	(1 times)
schäuchen	(scheuchen)	(1 times)
schöhn	(schön)	(1 times)
schömte	(schämte)	(1 times)
schönder	(schöner)	(1 times)
schönnen	(schönen)	(5 times)
schönner	(schöner)	(1 times)
schüsel	(Schüssel)	(2 times)
sedzen	(setzen)	(1 times)
sehnsüschtig	(sehnsüchtig)	(1 times)
sehtzen	(setzen)	(1 times)
sehtzt	(setzt)	(2 times)
sehtzte	(setzte)	(1 times)
seihner	(seiner)	(1 times)
seineem	(seinem)	(1 times)
selpst	(selbst)	(1 times)
setsen	(setzen)	(1 times)
sgt	(sagt)	(4 times)
sgte	(sagte)	(2 times)
sha	(sah)	(2 times)
shie	(sie)	(1 times)
si-	(sie)	(1 times)
sic	(sich)	(2 times)
sicn	(sich)	(1 times)
sidzt	(sitzt)	(1 times)
siee	(sie)	(1 times)
siend	(sind)	(13 times)
sihet	(sieht)	(2 times)
sikunden	(Sekunden)	(1 times)
silzt	(sitzt)	(1 times)
sindt	(sind)	(1 times)
sinnd	(sind)	(1 times)
sits	(sitz)	(1 times)
sitsen	(sitzen)	(3 times)
sitst	(sitzt)	(4 times)
sitzenen	(sitzenden)	(1 times)
sitzin	(sitzen)	(1 times)
sizen	(sitzen)	(4 times)
sizten	(sitzen)	(1 times)
sofart	(sofort)	(2 times)
sofiel	(soviel)	(1 times)
sofohrt	(sofort)	(1 times)
sofor	(sofort)	(3 times)
soford	(sofort)	(3 times)
sofot	(sofort)	(2 times)
soger	(sogar)	(10 times)
sogt	(sagt)	(1 times)
sohfort	(sofort)	(1 times)
sohon	(schon)	(1 times)
sonigen	(sonnigen)	(8 times)
soningen	(sonnigen)	(1 times)
sonniegen	(sonnigen)	(1 times)
sons	(sonst)	(4 times)
sont	(sonst)	(1 times)
sonzt	(sonst)	(2 times)
sovort	(sofort)	(5 times)
sowiso	(sowieso)	(1 times)
sowort	(sofort)	(1 times)
spanende	(spannende)	(1 times)
spanung	(Spannung)	(1 times)
sparang	(sprang)	(1 times)
spartziergang	(Spaziergang)	(1 times)
sparzieren	(spazieren)	(2 times)
sparziren	(spazieren)	(4 times)
spaschwein	(Sparschwein)	(1 times)
spasieren	(spazieren)	(4 times)
spater	(später)	(1 times)
spatzieren	(spazieren)	(19 times)
spatziet	(spaziert)	(1 times)
spatzihren	(spazieren)	(1 times)
spatziren	(spazieren)	(11 times)
spaziren	(spazieren)	(21 times)
spazirgang	(Spaziergang)	(4 times)
speter	(später)	(14 times)
spiellen	(spielen)	(1 times)
spietzName	(Spitzname)	(1 times)
spilen	(spielen)	(23 times)
spilt	(spielt)	(1 times)
sprag	(sprang)	(1 times)
sprarchlos	(sprachlos)	(1 times)
sprigt	(springt)	(2 times)
sprink	(spring)	(1 times)
sprinkt	(springt)	(12 times)
sprun	(Sprung)	(1 times)
sröstet	(tröstet)	(1 times)
ssurükgeden	(zurückgeben)	(1 times)
staigt	(steigt)	(1 times)
standt	(stand)	(2 times)
stannd	(stand)	(1 times)
stant	(stand)	(5 times)
starcken	(starken)	(1 times)
staub-sauger	(Staubsauger)	(1 times)
staubsauga	(Staubsauger)	(1 times)
staubsauker	(Staubsauger)	(1 times)
staupsauber	(Staubsauger)	(1 times)
staupsauger	(Staubsauger)	(2 times)
stausauger	(Staubsauger)	(5 times)
stautsaugter	(Staubsauger)	(1 times)
staziren	(spazieren)	(1 times)
steigehn	(steigen)	(1 times)
steken	(stecken)	(3 times)
stekt	(steckt)	(2 times)
stekte	(steckte)	(3 times)
stelhte	(stellte)	(1 times)
stellte-	(stellte)	(1 times)
stelt	(stehlt)	(1 times)
steraße	(Straße)	(1 times)
stiek	(stieg)	(2 times)
stimt	(stimmt)	(2 times)
stirpt	(stirbt)	(1 times)
stockchen	(Stöckchen)	(1 times)
stolbert	(stolpert)	(2 times)
stolpart	(stolpert)	(1 times)
stoop	(stopp)	(1 times)
stoterte	(stotterte)	(1 times)
strallte	(strahlte)	(1 times)
stram	(stramm)	(2 times)
strarken	(starken)	(1 times)
strekt	(streckt)	(1 times)
strekte	(streckte)	(1 times)
sträckt	(streckt)	(1 times)
stubst	(stupst)	(1 times)
stzen	(setzen)	(1 times)
stzät	(setzt)	(1 times)
stölpert	(stolpert)	(1 times)
stüft	(Stift)	(2 times)
stürtze	(stürze)	(1 times)
stürtzt	(stürzt)	(1 times)
sucnte	(suchte)	(1 times)
suhcht	(sucht)	(2 times)
sätzt	(setzt)	(1 times)
süser	(süßer)	(1 times)
tad	(tat)	(1 times)
tagges	(Tages)	(1 times)
tailen	(teilen)	(1 times)
tarurig	(traurig)	(2 times)
tas	(das)	(1 times)
tasächlich	(tatsächlich)	(1 times)
tatsechlich	(tatsächlich)	(1 times)
tatzechlich	(tatsächlich)	(1 times)
taurig	(traurig)	(1 times)
tedy	(Teddy)	(5 times)
tedyber	(Teddybär)	(2 times)
tedybär	(Teddybär)	(3 times)
tehma	(Thema)	(1 times)
teiel	(teil)	(1 times)
teielte	(teilte)	(1 times)
telefohn	(Telefon)	(1 times)
telefonirt	(telefoniert)	(2 times)
telefonirten	(telefonierten)	(1 times)
telefonnumer	(Telefonnummer)	(2 times)
telefonnuner	(Telefonnummer)	(1 times)
telefonumer	(Telefonnummer)	(1 times)
telefornert	(telefoniert)	(1 times)
telfon	(Telefon)	(1 times)
tellefon	(Telefon)	(1 times)
telofon	(Telefon)	(3 times)
telofonNumer	(Telefonnummer)	(1 times)
telofonieren	(telefonieren)	(1 times)
tenefon	(Telefon)	(1 times)
ter	(der)	(1 times)
toch	(doch)	(1 times)
tozdem	(trotzdem)	(1 times)
tragich	(tragisch)	(1 times)
trairig	(traurig)	(1 times)
trarig	(traurig)	(1 times)
trauchrig	(traurig)	(1 times)
trauf	(drauf)	(1 times)
trauig	(traurig)	(4 times)
trauraig	(traurig)	(1 times)
traureg	(traurig)	(3 times)
traurg	(traurig)	(2 times)
trauri	(traurig)	(1 times)
traurich	(traurig)	(54 times)
traurieg	(traurig)	(3 times)
traurik	(traurig)	(5 times)
tropht	(tropft)	(1 times)
trotdem	(trotzdem)	(1 times)
trotztem	(trotzdem)	(1 times)
trotztim	(trotzdem)	(1 times)
trourig	(traurig)	(1 times)
trozdem	(trotzdem)	(3 times)
trraurig	(traurig)	(1 times)
truarig	(traurig)	(1 times)
trunter	(drunter)	(1 times)
tröpfschen	(Tröpfchen)	(1 times)
tuhn	(tun)	(1 times)
tunde	(Stunde)	(1 times)
tzufriden	(zufrieden)	(1 times)
uarmt	(umarmt)	(1 times)
uberal	(überall)	(1 times)
uberall	(überall)	(3 times)
uberglücklich	(überglücklich)	(1 times)
uberrall	(überall)	(1 times)
uberschrift	(Überschrift)	(1 times)
ubersetzt	(übersetzt)	(1 times)
ubrig	(übrig)	(2 times)
udn	(und)	(1 times)
ueggelaufen	(weggelaufen)	(1 times)
umAmt	(umarmt)	(1 times)
umSons	(umsonst)	(1 times)
umahmt	(umarmt)	(1 times)
umahrmte	(umarmte)	(1 times)
umamen	(umarmen)	(6 times)
umamre	(umarme)	(1 times)
umamt	(umarmt)	(10 times)
umamte	(umarmte)	(3 times)
umamten	(umarmten)	(4 times)
umarmmte	(umarmte)	(1 times)
umarmnt	(umarmt)	(1 times)
umarmtete	(umarmte)	(1 times)
umarnt	(umarmt)	(1 times)
umbedinkt	(unbedingt)	(2 times)
umgedret	(umgedreht)	(2 times)
umgefalen	(umgefallen)	(3 times)
umgeffalen	(umgefallen)	(1 times)
umgekipt	(umgekippt)	(1 times)
umglük	(Unglück)	(1 times)
ummarmen	(umarmen)	(1 times)
ummarmmt	(umarmt)	(1 times)
umramen	(umarmen)	(1 times)
umsontst	(umsonst)	(1 times)
umsonzt	(umsonst)	(1 times)
umtamt	(umarmt)	(1 times)
una	(und)	(3 times)
unarmen	(umarmen)	(1 times)
unarmte	(umarmte)	(1 times)
unauffelig	(unauffällig)	(1 times)
und-	(und)	(2 times)
und-armte	(umarmte)	(1 times)
undd	(und)	(1 times)
unds	(und)	(1 times)
undten	(unten)	(1 times)
undter	(unter)	(2 times)
unfal	(Unfall)	(2 times)
ungeduldi	(ungeduldig)	(1 times)
ungefalen	(umgefallen)	(1 times)
ungehwöhnliche	(ungewöhnliche)	(1 times)
unger	(Hunger)	(2 times)
ungewickelt	(umgewickelt)	(1 times)
unglauplich	(unglaublich)	(1 times)
ungliklich	(unglücklich)	(1 times)
unglüch	(Unglück)	(1 times)
unl	(und)	(1 times)
unlen	(unten)	(1 times)
unnten	(unten)	(1 times)
unnter	(unter)	(1 times)
unrufer	(Anrufer)	(1 times)
unsehre	(unsere)	(1 times)
unsonst	(umsonst)	(1 times)
untaricht	(Unterricht)	(1 times)
untawegs	(unterwegs)	(1 times)
unterhalten-	(unterhalten)	(1 times)
untericht	(Unterricht)	(9 times)
unternemen	(unternehmen)	(1 times)
unterwecks	(unterwegs)	(1 times)
unterweks	(unterwegs)	(3 times)
unvall	(Unfall)	(1 times)
unvorsigtig	(unvorsichtig)	(1 times)
uon	(von)	(1 times)
urgentwas	(irgendwas)	(1 times)
uuf	(auf)	(2 times)
vackelig	(wackelig)	(1 times)
valoren	(verloren)	(2 times)
vartet	(wartet)	(3 times)
varzucht	(versucht)	(1 times)
vassen	(fassen)	(1 times)
vast	(fast)	(3 times)
veertig	(fertig)	(1 times)
vegessene	(vergessene)	(1 times)
vegiss	(vergiss)	(2 times)
vegt	(fegt)	(1 times)
vegzubringen	(wegzubringen)	(1 times)
vehrschwundende	(verschwundene)	(1 times)
veloren	(verloren)	(2 times)
venster	(Fenster)	(2 times)
vensterbank	(Fensterbank)	(1 times)
vepassen	(verpassen)	(1 times)
ver	(Der)	(1 times)
ver-sucht	(versucht)	(1 times)
verabschidete	(verabschiedete)	(1 times)
verblüft	(verblüfft)	(1 times)
verchwunden	(verschwunden)	(2 times)
verdamten	(verdammten)	(1 times)
vergesene	(vergessene)	(1 times)
vergesesn	(vergessen)	(1 times)
vergssen	(vergessen)	(1 times)
verlarene	(verlorene)	(1 times)
verliren	(verlieren)	(2 times)
verlirt	(verliert)	(1 times)
verlohr	(verlor)	(1 times)
verlohren	(verloren)	(3 times)
verlorende	(verlorene)	(1 times)
vermistt	(vermisst)	(1 times)
verpast	(verpasst)	(1 times)
verrschwunden	(verschwunden)	(2 times)
verschprachen	(versprachen)	(1 times)
verschunden	(verschwunden)	(2 times)
verschwant	(verschwand)	(1 times)
verschwuden	(verschwunden)	(1 times)
verschwundden	(verschwunden)	(1 times)
verschwundende	(verschwundene)	(1 times)
verschwunder	(verschwunden)	(1 times)
verschwundete	(verschwundene)	(1 times)
versehn	(Versehen)	(1 times)
verstckt	(versteckt)	(1 times)
verstekckt	(versteckt)	(1 times)
versteke	(verstecke)	(2 times)
versteken	(verstecken)	(1 times)
verstekt	(versteckt)	(5 times)
verstekte	(versteckte)	(1 times)
versträut	(verstreut)	(1 times)
versucrt	(versucht)	(1 times)
vertig	(fertig)	(15 times)
verwirte	(verwirrte)	(1 times)
verwolgen	(verfolgen)	(2 times)
verzfeifelt	(verzweifelt)	(1 times)
verzweifeld	(verzweifelt)	(2 times)
verzweiflet	(verzweifelt)	(1 times)
verzweihfelt	(verzweifelt)	(1 times)
verzweilfelt	(verzweifelt)	(1 times)
verückte	(verrückte)	(3 times)
vest	(fest)	(8 times)
vestgehalten	(festgehalten)	(2 times)
vestzuhalten	(festzuhalten)	(1 times)
vfro	(froh)	(1 times)
vielecht	(vielleicht)	(1 times)
vieleicht	(vielleicht)	(7 times)
viellen	(Vielen)	(1 times)
viellen	(vielen)	(1 times)
villeicht	(vielleicht)	(1 times)
ving	(fing)	(3 times)
virtelstunde	(Viertelstunde)	(1 times)
vleißig	(fleißig)	(1 times)
vliegt	(fliegt)	(3 times)
vligt	(fliegt)	(1 times)
vobei	(vorbei)	(1 times)
vohrher	(vorher)	(1 times)
voler	(voller)	(2 times)
volkomen	(vollkommen)	(1 times)
voller-	(voller)	(1 times)
vollllll	(voll)	(1 times)
voloren	(verloren)	(1 times)
vonn	(von)	(1 times)
vorbeikomt	(vorbeikommt)	(1 times)
voreher	(vorher)	(1 times)
vorlezten	(vorletzten)	(2 times)
vorloren	(verloren)	(1 times)
vorsichtg	(vorsichtig)	(1 times)
vosichig	(vorsichtig)	(1 times)
vosichtig	(vorsichtig)	(1 times)
vragt	(fragt)	(1 times)
vreude	(Freude)	(3 times)
vreute	(freute)	(1 times)
vridlich	(friedlich)	(1 times)
vrmisst	(vermisst)	(1 times)
vroh	(froh)	(1 times)
vrölich	(fröhlich)	(1 times)
vällt	(fällt)	(1 times)
vängt	(fängt)	(1 times)
völig	(völlig)	(1 times)
vür	(für)	(4 times)
wacklt	(wackelt)	(1 times)
waeiter	(weiter)	(1 times)
waggong	(Waggon)	(1 times)
wahrtette	(wartete)	(1 times)
wail	(weil)	(1 times)
waiter	(weiter)	(1 times)
wakcel	(wackel)	(1 times)
wakelig	(wackelig)	(1 times)
wakeln	(wackeln)	(2 times)
wakelt	(wackelt)	(11 times)
wakelte	(wackelte)	(6 times)
wakkeln	(wackeln)	(1 times)
wardet	(wartet)	(4 times)
warumm	(warum)	(1 times)
waserienierg	(fasziniert)	(1 times)
wast	(fast)	(7 times)
wecKgelaufen	(weggelaufen)	(1 times)
wecKlaufen	(weglaufen)	(1 times)
weckgelaufen	(weggelaufen)	(7 times)
weckseln	(wechseln)	(1 times)
weg.gerant	(weggerannt)	(1 times)
wegeflogen	(weggeflogen)	(1 times)
wegegangen	(weggegangen)	(2 times)
wegelaufen	(weggelaufen)	(5 times)
wegerant	(weggerannt)	(1 times)
wegetan	(wehgetan)	(11 times)
wegetanrn	(wehgetan)	(1 times)
wegfligt	(wegfliegt)	(1 times)
weggehlaufen	(weggelaufen)	(1 times)
weggelt	(weggeht)	(1 times)
weggerant	(weggerannt)	(7 times)
wegwerven	(wegwerfen)	(1 times)
wehg	(weg)	(1 times)
wehgehgetan	(wehgetan)	(1 times)
wehgen	(wegen)	(1 times)
weiel	(weil)	(8 times)
weihl	(weil)	(2 times)
weihnen	(weinen)	(2 times)
weill	(weil)	(14 times)
weiml	(weil)	(1 times)
weinnen	(weinen)	(1 times)
weints	(weinst)	(1 times)
weitagegangen	(weitergegangen)	(1 times)
wekgelafen	(weggelaufen)	(1 times)
wekgelauf	(weggelaufen)	(1 times)
wekgelaufen	(weggelaufen)	(7 times)
wekgerant	(weggerannt)	(2 times)
weleche	(welche)	(1 times)
wemand	(jemand)	(2 times)
wemm	(wem)	(1 times)
wenster	(Fenster)	(1 times)
werabredet	(verabredet)	(1 times)
wergessen	(vergessen)	(1 times)
werlor	(verlor)	(1 times)
werschwundene	(verschwundene)	(1 times)
werstekt	(versteckt)	(1 times)
wersucht	(versucht)	(2 times)
wertig	(fertig)	(2 times)
wetat	(wehtat)	(1 times)
widergefunden	(wiedergefunden)	(1 times)
widerhaben	(wiederhaben)	(2 times)
widerzusehen	(wiederzusehen)	(5 times)
wieeder	(wieder)	(1 times)
wiel	(fiel)	(5 times)
wiell	(will)	(2 times)
wiend	(Wind)	(1 times)
wienkte	(winkte)	(1 times)
wihrf	(wirf)	(1 times)
wikt	(winkt)	(1 times)
wilst	(willst)	(2 times)
winckte	(winkte)	(1 times)
wircklich	(wirklich)	(2 times)
wirglich	(wirklich)	(3 times)
wiso	(Wieso)	(2 times)
wiso	(wieso)	(7 times)
wliegt	(fliegt)	(1 times)
wmarmten	(umarmten)	(1 times)
wnd	(und)	(5 times)
wngeduldich	(ungeduldig)	(1 times)
wohnug	(Wohnung)	(1 times)
won	(von)	(3 times)
wonderschönen	(wunderschönen)	(1 times)
wonhin	(wohin)	(1 times)
wonung	(Wohnung)	(1 times)
wonzimmer	(Wohnzimmer)	(1 times)
wor	(vor)	(2 times)
worbei	(vorbei)	(1 times)
worf	(warf)	(1 times)
worher	(vorher)	(1 times)
wra	(war)	(1 times)
wragte	(fragte)	(2 times)
wreigelasen	(freigelassen)	(1 times)
wrtet	(wartet)	(1 times)
wunderschones	(wunderschönes)	(1 times)
wurklich	(wirklich)	(1 times)
wägwerfen	(wegwerfen)	(1 times)
wärend	(während)	(2 times)
wükend	(wütend)	(1 times)
wünderschöner	(wunderschöner)	(1 times)
wür	(für)	(2 times)
würklich	(wirklich)	(1 times)
yemand	(jemand)	(3 times)
zapellig	(zappelig)	(1 times)
zapelten	(zappelten)	(1 times)
zaulerei	(Zauberei)	(1 times)
zeik	(zeig)	(1 times)
zeikt	(zeigt)	(2 times)
zeikte	(zeigte)	(1 times)
zenster	(Fenster)	(1 times)
zerbochene	(zerbrochene)	(1 times)
zererte	(zerrte)	(1 times)
zeriss	(zerriss)	(2 times)
zerplazt	(zerplatzt)	(1 times)
zerris	(zerriss)	(2 times)
zerrisen	(zerrissen)	(1 times)
zertte	(zerrte)	(1 times)
zerzweilfett	(verzweifelt)	(1 times)
zetel	(Zettel)	(8 times)
zeuknis	(Zeugnis)	(1 times)
zewecklos	(zwecklos)	(1 times)
zihen	(ziehen)	(2 times)
ziht	(zieht)	(8 times)
zimlich	(ziemlich)	(2 times)
zo	(so)	(1 times)
zohg	(zog)	(1 times)
zraf	(traf)	(1 times)
zu-	(zu)	(1 times)
zu-gleich	(zugleich)	(1 times)
zufriden	(zufrieden)	(15 times)
zugesstoen	(zugestoßen)	(1 times)
zugewarfen	(zugeworfen)	(1 times)
zulasen	(zulassen)	(1 times)
zuletz	(zuletzt)	(1 times)
zurhause	(Zuhause)	(1 times)
zurrück	(zurück)	(1 times)
zuruck	(zurück)	(4 times)
zuröck	(zurück)	(1 times)
zurüggekomen	(zurückgekommen)	(1 times)
zurük	(zurück)	(21 times)
zurükgebracht	(zurückgebracht)	(1 times)
zurükgekomin	(zurückgekommen)	(1 times)
zurükhaben	(zurückhaben)	(1 times)
zussammen	(zusammen)	(2 times)
zuvriden	(zufrieden)	(1 times)
zw	(zu)	(4 times)
zwa	(zwar)	(2 times)
zwm	(zum)	(1 times)
zwrückkehrte	(zurückkehrte)	(1 times)
zärrt	(zerrt)	(1 times)
zürick	(zurück)	(1 times)
zürück	(zurück)	(6 times)
zürückkommt	(zurückkommt)	(1 times)
zürük	(zurück)	(4 times)
Änglich	(Endlich)	(1 times)
Überaschong	(Überraschung)	(1 times)
Überaschung	(Überraschung)	(6 times)
Überrachung	(Überraschung)	(1 times)
Überraschchung	(Überraschung)	(1 times)
Ürgendwan	(Irgendwann)	(1 times)
äber	(aber)	(1 times)
ägstra	(extra)	(1 times)
ällterer	(älterer)	(1 times)
ängslich	(ängstlich)	(1 times)
ängtlich	(ängstlich)	(1 times)
ärgentwo	(irgendwo)	(1 times)
ätwas	(etwas)	(1 times)
öfnet	(öffnet)	(1 times)
öfnete	(öffnete)	(5 times)
öfneten	(öffneten)	(1 times)
öhrgendetwas	(irgendetwas)	(1 times)
über-	(über)	(1 times)
überal	(überall)	(24 times)
überalh	(überall)	(1 times)
überalle	(überall)	(1 times)
überascht	(überrascht)	(2 times)
überaschung	(Überraschung)	(11 times)
überfahn	(überfahren)	(1 times)
überglüglich	(überglücklich)	(2 times)
überglüklich	(überglücklich)	(4 times)
überhollen	(überholen)	(1 times)
überral	(überall)	(1 times)
überrall	(überall)	(1 times)
überzeügt	(überzeugt)	(1 times)
übrenachtet	(übernachtet)	(1 times)
ülberall	(überall)	(1 times)
ünglück	(Unglück)	(1 times)
