-aufgestanden	(aufgestanden)	(1 times)
Aallle	(Alle)	(1 times)
Aals	(Als)	(1 times)
Aalte	(alte)	(2 times)
Aaresse	(Adresse)	(1 times)
Aauf	(Auf)	(3 times)
Aaus	(Aus)	(1 times)
Aause	(Hause)	(1 times)
Abar	(Aber)	(1 times)
Abbar	(Aber)	(1 times)
Abe	(Aber)	(1 times)
Abeit	(Arbeit)	(1 times)
Abgehelt	(abgeholt)	(1 times)
Absich	(Absicht)	(1 times)
Achtug	(Achtung)	(1 times)
Aderese	(Adresse)	(1 times)
Adrese	(Adresse)	(1 times)
Adrresse	(Adresse)	(1 times)
Aein	(ein)	(1 times)
Agerufen	(angerufen)	(1 times)
Ale	(Alle)	(4 times)
Ales	(Alles)	(2 times)
Alls	(Als)	(17 times)
Allte	(alte)	(2 times)
Alr	(Als)	(2 times)
Alz	(Als)	(2 times)
Angekomen	(angekommen)	(1 times)
Angts	(Angst)	(1 times)
Anhatten	(anhalten)	(1 times)
Annruff	(Anruf)	(1 times)
Anrruft	(anruft)	(1 times)
Anru=f	(Anruf)	(2 times)
Anruft	(Anruf)	(1 times)
Anruhf	(Anruf)	(1 times)
Anschließen	(Anschließend)	(1 times)
Anschlißend	(Anschließend)	(1 times)
Anstat	(Anstatt)	(1 times)
Antort	(Antwort)	(1 times)
Aperat	(Apparat)	(1 times)
Arber	(Aber)	(1 times)
Aruf	(Anruf)	(1 times)
Auf-	(Auf)	(1 times)
Aufgehregt	(aufgeregt)	(1 times)
AugenbliK	(Augenblick)	(1 times)
Auss	(Aus)	(1 times)
Auß	(Aus)	(1 times)
Baden	(Boden)	(1 times)
Bahm	(Bahn)	(1 times)
Bark	(Park)	(2 times)
Bas	(Bus)	(1 times)
Bauhen	(bauen)	(1 times)
Bbätter	(Blätter)	(1 times)
Beelt	(bellt)	(1 times)
Befor	(Bevor)	(2 times)
Begrusten	(begrüßten)	(1 times)
Beibe	(Beide)	(1 times)
Bekomen	(bekommen)	(2 times)
Beld	(Bild)	(1 times)
Beniner-	(Berliner)	(1 times)
Besizer	(Besitzer)	(1 times)
Bestimt	(Bestimmt)	(1 times)
Betel	(Beutel)	(1 times)
Beu-tel	(Beutel)	(1 times)
Beurtel	(Beutel)	(1 times)
Beuter	(Beutel)	(1 times)
Bewekt	(bewegt)	(1 times)
Bewoner	(Bewohner)	(1 times)
Bielder	(Bilder)	(1 times)
Bilt	(Bild)	(1 times)
Blakate	(Plakate)	(2 times)
Blat	(Blatt)	(7 times)
Bleb	(Bleib)	(1 times)
Blider	(Bilder)	(1 times)
Blitzt	(Blitz)	(1 times)
Blumenstraus	(Blumenstrauß)	(1 times)
Blutzlich	(Plötzlich)	(1 times)
Blädter	(Blätter)	(1 times)
Bläter	(Blätter)	(1 times)
Blötzlich	(Plötzlich)	(1 times)
Bonen	(Boden)	(1 times)
Buden	(Boden)	(1 times)
Bur	(Bus)	(2 times)
Burgersteik	(Bürgersteig)	(1 times)
Burkersteik	(Bürgersteig)	(1 times)
Buses	(Busses)	(2 times)
Busfarher	(Busfahrer)	(1 times)
Busfuhrer	(Busfahrer)	(1 times)
Bushalltestelle	(Bushaltestelle)	(1 times)
Bushaltestele	(Bushaltestelle)	(1 times)
Buss	(Bus)	(42 times)
Busshaltestelle	(Bushaltestelle)	(1 times)
Buß	(Bus)	(1 times)
Bäutel	(Beutel)	(7 times)
Büll	(Müll)	(1 times)
D	(Da)	(1 times)
Dabai	(Dabei)	(1 times)
Dabhei	(Dabei)	(1 times)
Dach	(Doch)	(2 times)
Dadybär	(Teddybär)	(2 times)
Dafon	(davon)	(1 times)
Dah	(Da)	(1 times)
Damme	(Dame)	(1 times)
Dan	(Dann)	(40 times)
Danachh	(Danach)	(1 times)
Danch	(Danach)	(1 times)
Danck	(Dank)	(1 times)
Dancke	(Danke)	(3 times)
Dann-	(Dann)	(1 times)
Dannach	(Danach)	(8 times)
Dannach	(danach)	(2 times)
Dar	(Da)	(5 times)
Darbei	(Dabei)	(1 times)
DasWegen	(Deswegen)	(1 times)
Dasche	(Tasche)	(1 times)
Dass	(Das)	(1 times)
Daswegen	(Deswegen)	(1 times)
Daw	(Da)	(1 times)
Denn	(Dann)	(1 times)
Deusch	(Deutsch)	(1 times)
Dierekt	(Direkt)	(1 times)
Diregt	(Direkt)	(1 times)
Do	(Da)	(1 times)
Docb	(Doch)	(1 times)
Donach	(Danach)	(1 times)
Donerstag	(Donnerstag)	(2 times)
Drausen	(Draußen)	(2 times)
Dreckt	(Dreck)	(1 times)
Drek	(Dreck)	(1 times)
Drükt	(drückt)	(1 times)
Dunach	(Danach)	(2 times)
Dunn	(Dann)	(2 times)
Dänke	(Danke)	(1 times)
Echsplosohn	(Explosion)	(1 times)
Ecker	(Ecke)	(1 times)
Eeinen	(Einen)	(1 times)
Eeis	(Eis)	(12 times)
Eende	(Ende)	(1 times)
Eiemal	(Einmal)	(1 times)
Eienes	(Eines)	(1 times)
Einkaufzentrum	(Einkaufszentrum)	(1 times)
Eins	(Eines)	(1 times)
Eisdile	(Eisdiele)	(2 times)
Eisi	(Eis)	(1 times)
Eistile	(Eisdiele)	(1 times)
Eke	(Ecke)	(2 times)
Elter	(Eltern)	(1 times)
Endliech	(Endlich)	(1 times)
Endschuldigung	(Entschuldigung)	(2 times)
Englich	(Endlich)	(1 times)
Enschuldigung	(Entschuldigung)	(2 times)
Entlich	(Endlich)	(2 times)
Entschuldiegung	(Entschuldigung)	(1 times)
Erger	(Ärger)	(1 times)
Erns	(Ernst)	(1 times)
Ers	(Er)	(1 times)
Erschroken	(Erschrocken)	(1 times)
Erschroken	(erschrocken)	(1 times)
Erstaund	(erstaunt)	(1 times)
Esen	(Essen)	(4 times)
Expliosion	(Explosion)	(1 times)
Explodirt	(explodiert)	(1 times)
Eäschrocken	(erschrocken)	(1 times)
Fagsen	(Faxen)	(1 times)
Fahrbe	(Farbe)	(1 times)
Fedy	(Teddy)	(1 times)
Fehnster	(Fenster)	(2 times)
Fehrnsehen	(Fernsehen)	(1 times)
Fensder	(Fenster)	(1 times)
Fensta	(Fenster)	(2 times)
Fenstbank	(Fensterbank)	(1 times)
Fenste	(Fenster)	(11 times)
Fenstehr	(Fenster)	(2 times)
Fenster-bank	(Fensterbank)	(1 times)
FensterRamen	(Fensterrahmen)	(1 times)
Fensterbret	(Fensterbrett)	(1 times)
Fensterbund	(Fensterbank)	(1 times)
Fensterhanck	(Fensterbank)	(1 times)
Fensterramen	(Fensterrahmen)	(6 times)
Fensterscheib	(Fensterscheibe)	(1 times)
Fenstr	(Fenster)	(1 times)
Fenter	(Fenster)	(1 times)
Fenzter	(Fenster)	(3 times)
FenzterBank	(Fensterbank)	(1 times)
Fenzterscheibe	(Fensterscheibe)	(1 times)
Ferabschiedet	(verabschiedet)	(1 times)
Ferbredeten	(verabredeten)	(1 times)
Fergessen	(vergessen)	(1 times)
Ferkeuver	(Verkäufer)	(1 times)
Ferkäufer	(Verkäufer)	(1 times)
Ferloren	(verloren)	(1 times)
Ferlorene	(Verlorene)	(1 times)
Ferlorene	(verlorene)	(2 times)
Fermist	(vermisst)	(1 times)
Fernster	(Fenster)	(2 times)
Ferschwunden	(verschwunden)	(4 times)
Ferstckt	(versteckt)	(1 times)
Ferster	(Fenster)	(2 times)
Fersucht	(versucht)	(1 times)
Ferwundert	(Verwundert)	(1 times)
Fesntenerbank	(Fensterbank)	(1 times)
Fesnter	(Fenster)	(1 times)
Fester	(Fenster)	(2 times)
Festerscheibe	(Fensterscheibe)	(1 times)
Feund	(Freund)	(1 times)
Fhenster	(Fenster)	(1 times)
Fleach	(Fleisch)	(1 times)
Fligende	(fliegende)	(4 times)
Flu	(Flur)	(1 times)
Flus	(Fluss)	(2 times)
Fnster	(Fenster)	(4 times)
Fogel	(Vogel)	(1 times)
Forosch	(Frosch)	(1 times)
Forsch	(Frosch)	(2 times)
Forsichtzhalber	(Vorsichtshalber)	(1 times)
Fota	(Foto)	(1 times)
Fra	(Frau)	(1 times)
Frauf	(Frau)	(1 times)
Fraut	(Frau)	(1 times)
Freind	(Freund)	(1 times)
Freud	(Freund)	(2 times)
Freundinn	(Freundin)	(1 times)
Freunt	(Freund)	(5 times)
Fro	(froh)	(3 times)
Froch	(Frosch)	(17 times)
Frode	(Freude)	(1 times)
Frschundene	(verschwundene)	(1 times)
Frusch	(Frosch)	(1 times)
Frölich	(Fröhlich)	(2 times)
Frölich	(fröhlich)	(4 times)
Frü	(Früh)	(1 times)
Früling	(Frühling)	(2 times)
Früstück	(Frühstück)	(1 times)
Fuau	(Frau)	(1 times)
Fur	(Für)	(1 times)
Futer	(Futter)	(2 times)
Fänster	(Fenster)	(3 times)
Fötchen	(Pfötchen)	(1 times)
Führ	(Für)	(1 times)
Fülehr	(Füller)	(1 times)
Fünten	(fünften)	(1 times)
Fütter	(Futter)	(3 times)
Gantz	(ganz)	(1 times)
Gasi	(Gassi)	(1 times)
Gassie	(Gassi)	(1 times)
Gassy	(Gassi)	(1 times)
Gechenk	(Geschenk)	(1 times)
Gechichte	(Geschichte)	(2 times)
Gefonden	(gefunden)	(1 times)
Gegent	(Gegend)	(2 times)
Gehfühl	(Gefühl)	(1 times)
Gehfül	(Gefühl)	(1 times)
Gehn	(Gehen)	(1 times)
Gehtan	(getan)	(2 times)
Gekomen	(gekommen)	(1 times)
Gereusch	(Geräusch)	(1 times)
Geschefte	(Geschäfte)	(1 times)
Geschek	(Geschenk)	(1 times)
Gescheng	(Geschenk)	(2 times)
Geschßent	(Geschenk)	(1 times)
Geschäftsman	(Geschäftsmann)	(1 times)
Gesichtausdrük	(Gesichtsausdruck)	(1 times)
Gesichtsausdruk	(Gesichtsausdruck)	(1 times)
Gischichte	(Geschichte)	(1 times)
Glascheibe	(Glasscheibe)	(1 times)
Glasschärben	(Glasscherben)	(1 times)
Glicklich	(glücklich)	(1 times)
Gluck-lich	(glücklich)	(1 times)
Gluckich	(glücklich)	(1 times)
Glucklich	(glücklich)	(3 times)
Gluk	(Glück)	(1 times)
Gläsa	(Gläser)	(1 times)
Glücklieste	(glücklichste)	(1 times)
Glücklig	(glücklich)	(1 times)
Glücklisch	(glücklich)	(1 times)
Glücklische	(glückliche)	(1 times)
Glüklich	(glücklich)	(7 times)
Glüklich-	(glücklich)	(1 times)
Glüklicher	(glücklicher)	(1 times)
Glüklisch	(glücklich)	(1 times)
Graten	(Garten)	(1 times)
Grif	(Griff)	(1 times)
Gucgt	(guckt)	(1 times)
Hacken	(Haken)	(1 times)
Halltestelle	(Haltestelle)	(1 times)
Halsban	(Halsband)	(1 times)
Halsbant	(Halsband)	(1 times)
Halskete	(Halskette)	(1 times)
Halteschtelle	(Haltestelle)	(1 times)
Haltestehle	(Haltestelle)	(1 times)
Haltestele	(Haltestelle)	(1 times)
Halz	(Hals)	(1 times)
Halzband	(Halsband)	(2 times)
Halzbant	(Halsband)	(1 times)
Hande	(Hände)	(1 times)
Hant	(Hand)	(1 times)
Hare	(Haare)	(1 times)
Harren	(Haaren)	(1 times)
Hase	(Hause)	(1 times)
Hausa	(Hause)	(1 times)
Hausabeit	(Hausarbeit)	(1 times)
Hausarest	(Hausarrest)	(2 times)
Hauser	(Häuser)	(1 times)
Hauserrest	(Hausarrest)	(2 times)
Hausofgaben	(Hausaufgaben)	(1 times)
Haws	(Haus)	(1 times)
Heer	(Herr)	(3 times)
Henden	(Händen)	(1 times)
Hendler	(Händler)	(1 times)
Hengt	(Hängt)	(1 times)
Hengt	(hängt)	(8 times)
Hengten	(hängten)	(1 times)
Henterher	(hinterher)	(1 times)
Her.	(Herr)	(2 times)
Herr.	(Herr)	(3 times)
Herrschen	(Herrchen)	(1 times)
Hir	(Hier)	(2 times)
Hlfe	(Hilfe)	(1 times)
Hochker	(Hocker)	(1 times)
Hofnwng	(Hoffnung)	(1 times)
Hoker	(Hocker)	(1 times)
Hols	(Holz)	(1 times)
Horben	(Haben)	(1 times)
Horst	(hörst)	(1 times)
Hosse	(Hose)	(1 times)
Hrr	(Herr)	(1 times)
Hud	(Hund)	(1 times)
Hudn	(Hund)	(1 times)
HundeFuter	(Hundefutter)	(1 times)
Hundefter	(Hundefutter)	(1 times)
Hundefuder	(Hundefutter)	(1 times)
Hundefuter	(Hundefutter)	(3 times)
Hundefütter	(Hundefutter)	(2 times)
Hunderfutter	(Hundefutter)	(1 times)
Hundfuter	(Hundefutter)	(1 times)
Hundfutter	(Hundefutter)	(1 times)
Hunkrich	(hungrig)	(1 times)
Hunt	(Hund)	(4 times)
Huse	(Hause)	(4 times)
Hwndefwtter	(Hundefutter)	(1 times)
Händ	(Hand)	(1 times)
Höer	(Hörer)	(1 times)
Hörer	(Höre)	(1 times)
Idde	(Idee)	(2 times)
Ide	(Idee)	(1 times)
Ihn	(In)	(2 times)
Inenstad	(Innenstadt)	(1 times)
Inochen	(Knochen)	(1 times)
Ir	(Er)	(1 times)
Irgentwan	(Irgendwann)	(1 times)
Jack	(Jacke)	(3 times)
Jacka	(Jacke)	(1 times)
Jake	(Jacke)	(31 times)
Jargt	(jagt)	(1 times)
Jeber	(jeder)	(1 times)
Jedz	(Jetzt)	(1 times)
Jemad	(jemand)	(1 times)
Jemahd	(Jemand)	(1 times)
Jeman	(jemand)	(1 times)
Jemant	(Jemand)	(1 times)
Jetct	(jetzt)	(1 times)
Jetz	(Jetzt)	(7 times)
Jezt	(Jetzt)	(4 times)
Jezt	(jetzt)	(5 times)
Jeztt	(Jetzt)	(1 times)
Jiemand	(jemand)	(1 times)
Jitzt	(jetzt)	(1 times)
Juge	(Junge)	(1 times)
Jung	(Junge)	(3 times)
Jurge	(Junge)	(1 times)
Kabbine	(Kabine)	(1 times)
Kaffe	(Kaffee)	(1 times)
Kakon	(Karton)	(1 times)
Kan	(Kann)	(1 times)
Kannte	(Kante)	(1 times)
Kanst	(Kannst)	(4 times)
Kapputte	(kaputte)	(1 times)
Kaput	(kaputt)	(6 times)
Kaputen	(kaputten)	(1 times)
Kartog	(Karton)	(2 times)
Kartong	(Karton)	(20 times)
Kartongt	(Karton)	(3 times)
Kartonk	(Karton)	(1 times)
Katog	(Karton)	(2 times)
Katon	(Karton)	(2 times)
Katong	(Karton)	(41 times)
Katonk	(Karton)	(4 times)
Katorn	(Karton)	(1 times)
Kaufem	(kaufen)	(1 times)
Kauffen	(kaufen)	(1 times)
Keld	(Geld)	(1 times)
Kerpst	(Herbst)	(1 times)
Kete	(Kette)	(3 times)
Kinde	(Kinder)	(1 times)
Kingelt	(klingelt)	(1 times)
Kis=te	(Kiste)	(1 times)
Kisste	(Kiste)	(1 times)
Kist	(Kiste)	(1 times)
Klase	(Klasse)	(1 times)
Klass	(Klasse)	(2 times)
Klassenkammeraden	(Klassenkameraden)	(1 times)
Klassenlererin	(Klassenlehrerin)	(1 times)
Klassenraumm	(Klassenraum)	(1 times)
Klassenszimmer	(Klassenzimmer)	(1 times)
Klassenzimer	(Klassenzimmer)	(1 times)
Klepte	(klebte)	(1 times)
Klinelt	(Klingelt)	(1 times)
Klinelt	(klingelt)	(1 times)
Klinelte	(klingelte)	(1 times)
Klingell	(Klingel)	(1 times)
Klingert	(klingelt)	(1 times)
Kmochen	(Knochen)	(1 times)
Kniee	(Knie)	(1 times)
Knochel	(Knochen)	(2 times)
Knoden	(Knoten)	(1 times)
Knohen	(Knochen)	(1 times)
Knuten	(Knoten)	(1 times)
Komen	(kommen)	(2 times)
Komt	(kommt)	(1 times)
Konzentrirt	(konzentriert)	(2 times)
Korf	(Kopf)	(1 times)
Korper	(Körper)	(1 times)
Koten	(Knoten)	(1 times)
Kpof	(Kopf)	(1 times)
Kralen	(Krallen)	(3 times)
Kummpel	(Kumpel)	(1 times)
Kurtz	(Kurz)	(3 times)
Kurwe	(Kurve)	(1 times)
Küsche	(Küche)	(2 times)
La	(Ja)	(1 times)
Lader	(Laden)	(1 times)
Lamsam	(langsam)	(1 times)
Langweiten	(langweilen)	(1 times)
Lansam	(langsam)	(1 times)
Las	(Lass)	(1 times)
Lechelnde	(lächelnde)	(1 times)
Lechelt	(lächelt)	(1 times)
Lechelte	(lächelte)	(1 times)
Leckerlie	(Leckerli)	(5 times)
Leharin	(Lehrerin)	(1 times)
Leherin	(Lehrerin)	(7 times)
Leherrin	(Lehrerin)	(2 times)
Lehraren	(Lehrerin)	(1 times)
Lehrarin	(Lehrerin)	(1 times)
Lehrehrin	(Lehrerin)	(1 times)
Lehrelien	(Lehrerin)	(1 times)
Lehreren	(Lehrerin)	(3 times)
Lehrerien	(Lehrerin)	(2 times)
Lehrerine	(Lehrerin)	(1 times)
Lehrerinn	(Lehrerin)	(2 times)
Lenerinnen	(Lehrerinnen)	(1 times)
Lerarin	(Lehrerin)	(2 times)
Lerer	(Lehrer)	(1 times)
Lereren	(Lehrerin)	(2 times)
Lererin	(Lehrerin)	(19 times)
Lererinen	(Lehrerinnen)	(1 times)
Lerm	(Lärm)	(3 times)
Lerrerien	(Lehrerin)	(1 times)
Lerrerin	(Lehrerin)	(2 times)
Leschelte	(lächelte)	(1 times)
Letsten	(letzten)	(1 times)
Lie	(Sie)	(1 times)
Lieft	(Lift)	(2 times)
Lohrarin	(Lehrerin)	(1 times)
Maan	(Mann)	(2 times)
Madchen	(Mädchen)	(2 times)
Madschen	(Mädchen)	(1 times)
Mahte	(Mathe)	(8 times)
Mamar	(Mama)	(1 times)
Man	(Mann)	(28 times)
Mann	(Man)	(1 times)
Mantell	(Mantel)	(2 times)
Margen	(Magen)	(1 times)
Matamatig	(Mathematik)	(1 times)
Mate	(Mathe)	(1 times)
Matematig	(Mathematik)	(2 times)
Mauea	(Mauer)	(1 times)
Maur	(Mauer)	(1 times)
Medel	(Mädel)	(1 times)
Medschen	(Mädchen)	(1 times)
Minut	(Minute)	(1 times)
Minwten	(Minuten)	(1 times)
Mistgeschig	(Missgeschick)	(1 times)
Miterg	(Mittag)	(1 times)
Mituden	(Minuten)	(1 times)
Mitwoch	(Mittwoch)	(1 times)
Mißchon	(Mission)	(1 times)
Mogens	(Morgens)	(1 times)
Morges	(Morgens)	(1 times)
Mrgens	(Morgens)	(1 times)
Mulleimer	(Mülleimer)	(1 times)
Munt	(Mund)	(2 times)
Muter	(Mutter)	(1 times)
Mächen	(Mädchen)	(8 times)
Mädschen	(Mädchen)	(1 times)
Mänchen	(Mädchen)	(2 times)
Mätchen	(Mädchen)	(5 times)
Mäuer	(Mauer)	(1 times)
Möchtes	(Möchtest)	(1 times)
Mühl	(Müll)	(1 times)
Müleimer	(Mülleimer)	(1 times)
Mülleinmer	(Mülleimer)	(1 times)
Mülltone	(Mülltonne)	(4 times)
Mültone	(Mülltonne)	(1 times)
Nachbarien	(Nachbarin)	(1 times)
Nachber	(Nachbar)	(5 times)
Nachberim	(Nachbarin)	(1 times)
Nachberin	(Nachbarin)	(6 times)
Nachberinn	(Nachbarin)	(1 times)
Nachbern	(Nachbarn)	(2 times)
Nachberrin	(Nachbarin)	(1 times)
Nachberschafft	(Nachbarschaft)	(1 times)
Nacher	(Nachher)	(1 times)
Nachicht	(Nachricht)	(2 times)
Nachichten	(Nachrichten)	(1 times)
Nachmitag	(Nachmittag)	(4 times)
Nachmiterg	(Nachmittag)	(1 times)
Nachmitttag	(Nachmittag)	(1 times)
Nachtbar	(Nachbar)	(1 times)
Nann	(Dann)	(1 times)
Nartbarschaft	(Nachbarschaft)	(1 times)
Nartürlich	(natürlich)	(1 times)
Nasse	(Nase)	(1 times)
Naturlich	(Natürlich)	(3 times)
Nerfige	(nervige)	(1 times)
Nrummer	(Nummer)	(1 times)
Numer	(Nummer)	(7 times)
Okey	(Okay)	(9 times)
Okey	(okay)	(2 times)
Omer	(Oma)	(1 times)
One	(ohne)	(1 times)
Pack	(Park)	(1 times)
Paffekt	(perfekt)	(1 times)
Painlich	(peinlich)	(1 times)
Pakatte	(Plakate)	(1 times)
Par	(Paar)	(1 times)
Parck	(Park)	(3 times)
Parg	(Park)	(2 times)
Pas	(Pass)	(1 times)
Pasiert	(passiert)	(3 times)
Pasirte	(passierte)	(2 times)
Passiren	(passieren)	(2 times)
Passirte	(passierte)	(1 times)
Peimlich	(peinlich)	(1 times)
Perfeckt	(perfekt)	(1 times)
Pfand	(fand)	(1 times)
PlaKarte	(Plakate)	(2 times)
Plackarte	(Plakate)	(1 times)
Plackat	(Plakat)	(3 times)
Plackate	(Plakate)	(12 times)
Plackaten	(Plakaten)	(1 times)
Plakade	(Plakate)	(1 times)
Plakal	(Plakat)	(1 times)
Plakart	(Plakat)	(1 times)
Plakarte	(Plakate)	(13 times)
Plakata	(Plakate)	(1 times)
Plakte	(Plakate)	(1 times)
Plarkard	(Plakat)	(1 times)
Plarkarte	(Plakate)	(1 times)
Plarkate	(Plakate)	(1 times)
Platzt	(Platz)	(1 times)
Plockate	(Plakate)	(1 times)
Plotzlich	(Plötzlich)	(25 times)
Plozlich	(Plötzlich)	(1 times)
Pluzlich	(Plötzlich)	(1 times)
Plätzlich	(Plötzlich)	(1 times)
Plöchlich	(Plötzlich)	(1 times)
Plölich	(Plötzlich)	(2 times)
Plölzlich	(Plötzlich)	(3 times)
Plötlich	(Plötzlich)	(2 times)
Plötslirch	(Plötzlich)	(1 times)
Plötzliche	(Plötzlich)	(1 times)
Plötzlig	(Plötzlich)	(2 times)
Plötzlisch	(Plötzlich)	(1 times)
Plötztlich	(Plötzlich)	(1 times)
Plözich	(Plötzlich)	(1 times)
Plözlich	(Plötzlich)	(40 times)
Plözlich	(plötzlich)	(2 times)
Plöztich	(Plötzlich)	(1 times)
Plöztlch	(Plötzlich)	(1 times)
Plöztlich	(Plötzlich)	(4 times)
Poblem	(Problem)	(1 times)
Poliezei	(Polizei)	(1 times)
Posta	(Poster)	(1 times)
Postan	(Poster)	(1 times)
Pplatz	(Platz)	(1 times)
Prefeckte	(perfekte)	(1 times)
Prinsesin	(Prinzessin)	(1 times)
Pöltzlich	(Plötzlich)	(1 times)
Pölzlich	(Plötzlich)	(1 times)
Pötzlich	(Plötzlich)	(1 times)
Pötzlich	(plötzlich)	(2 times)
Pözlich	(Plötzlich)	(1 times)
Qatschen	(quatschen)	(1 times)
Qatschten	(quatschten)	(1 times)
RUcksag	(Rucksack)	(1 times)
Ragete	(Rakete)	(1 times)
Ranzten	(Ranzen)	(1 times)
Rechen	(Rechnen)	(1 times)
Reumt	(räumt)	(1 times)
Rocksag	(Rucksack)	(2 times)
Ruchsack	(Rucksack)	(4 times)
Ruckcksack	(Rucksack)	(1 times)
Rucksach	(Rucksack)	(2 times)
Rucksacksack	(Rucksack)	(1 times)
Rucksag	(Rucksack)	(5 times)
Rucksagk	(Rucksack)	(3 times)
Rucksagt	(Rucksack)	(1 times)
Rucksak	(Rucksack)	(31 times)
Rucksasck	(Rucksack)	(1 times)
Rucksuch	(Rucksack)	(1 times)
Rucksuck	(Rucksack)	(2 times)
Rucktack	(Rucksack)	(1 times)
Ruhgsak	(Rucksack)	(3 times)
Rukesack	(Rucksack)	(1 times)
Ruksack	(Rucksack)	(2 times)
Ruksag	(Rucksack)	(6 times)
Ruksak	(Rucksack)	(4 times)
Ruksck	(Rucksack)	(1 times)
Rurksak	(Rucksack)	(1 times)
Räschnenaufgabe	(Rechenaufgabe)	(1 times)
Röken	(Rücken)	(1 times)
SPaßirgang	(Spaziergang)	(1 times)
Sa	(Ja)	(2 times)
Sammstag	(Samstag)	(2 times)
Samsta	(Samstag)	(1 times)
Schautd	(schaut)	(1 times)
Schbazieren	(spazieren)	(1 times)
Schielzeug	(Spielzeug)	(1 times)
Schlaffzimmer	(Schlafzimmer)	(1 times)
Schle	(Schule)	(6 times)
Schlekte	(schleckte)	(1 times)
Schlimste	(schlimmste)	(1 times)
Schlislich	(Schließlich)	(1 times)
Schlus	(Schluss)	(1 times)
Schmeisen	(schmeißen)	(1 times)
Schmertz	(Schmerz)	(1 times)
Schnel	(Schnell)	(3 times)
Schnel	(schnell)	(2 times)
Schnupert	(schnuppert)	(1 times)
Schok	(Schock)	(2 times)
Schreiben	(Scheiben)	(1 times)
Schreiptisch	(Schreibtisch)	(1 times)
Schrit	(Schritt)	(1 times)
Schrite	(Schritte)	(1 times)
Schtaubsaugen	(Staubsauger)	(1 times)
Schtaubsauger	(Staubsauger)	(2 times)
Schtaupsauger	(Staubsauger)	(1 times)
Schtrömt	(strömt)	(1 times)
Schubsauger	(Staubsauger)	(1 times)
Schuhle	(Schule)	(12 times)
Schuhlhof	(Schulhof)	(1 times)
Schul	(Schule)	(1 times)
Schuler	(Schüler)	(1 times)
Schulgebeude	(Schulgebäude)	(1 times)
Schulle	(Schule)	(4 times)
Schullfeg	(Schulweg)	(1 times)
Schulule	(Schule)	(1 times)
Schur	(Schnur)	(2 times)
Schussel	(Schüssel)	(1 times)
Schwans	(Schwanz)	(1 times)
Schwantz	(Schwanz)	(1 times)
Schünen	(schönen)	(1 times)
Schüs	(Tschüs)	(1 times)
Schüsel	(Schüssel)	(1 times)
Seill	(Seil)	(3 times)
Settel	(Zettel)	(1 times)
Si	(Sie)	(2 times)
Siben	(sieben)	(1 times)
Siest	(Siehst)	(1 times)
Sihe	(Sie)	(1 times)
Soforle	(Sofort)	(1 times)
Soger	(Sogar)	(1 times)
Sonigen	(sonnigen)	(1 times)
Sonniegen	(sonnigen)	(1 times)
Sontagmorgen	(Sonntagmorgen)	(2 times)
Spacieren	(spazieren)	(1 times)
SparzirStok	(Spazierstock)	(1 times)
Sparziren	(spazieren)	(2 times)
Sparzirgang	(Spaziergang)	(1 times)
Spas	(Spaß)	(1 times)
Spasirgan	(Spaziergang)	(1 times)
Spater	(Später)	(1 times)
Spatziren	(spazieren)	(2 times)
Spatzirgang	(Spaziergang)	(1 times)
Spazihren	(spazieren)	(1 times)
Spaziren	(spazieren)	(2 times)
Spazirgang	(Spaziergang)	(1 times)
Spelte	(spielte)	(1 times)
Speter	(Später)	(3 times)
Speter	(später)	(1 times)
Spil	(Spiel)	(1 times)
Spliter	(Splitter)	(1 times)
Spriengt	(springt)	(2 times)
Staadt	(Stadt)	(1 times)
Stab	(Staub)	(1 times)
Stad	(Stadt)	(11 times)
Staine	(Steine)	(2 times)
Stat	(Stadt)	(2 times)
Statd	(Stadt)	(6 times)
StauPsauger	(Staubsauger)	(2 times)
Staubsager	(Staubsauger)	(1 times)
Staubsauga	(Staubsauger)	(1 times)
Staubsaugen	(Staubsauger)	(1 times)
Staubsauger-	(Staubsauger)	(1 times)
Staubsaugrr	(Staubsauger)	(1 times)
Staubseuger	(Staubsauger)	(2 times)
Staudsauger	(Staubsauger)	(1 times)
Staugsauger	(Staubsauger)	(1 times)
Staupsauber	(Staubsauger)	(1 times)
Staupsauga	(Staubsauger)	(1 times)
Staupsauger	(Staubsauger)	(16 times)
Stauptsauga	(Staubsauger)	(1 times)
Stelte	(stellte)	(1 times)
Stieft	(Stift)	(6 times)
Stif	(Stift)	(1 times)
Stifft	(Stift)	(1 times)
Stime	(Stimme)	(1 times)
Stok	(Stock)	(1 times)
Stplitter	(Splitter)	(1 times)
Straffe	(Strafe)	(1 times)
Strase	(Straße)	(2 times)
Strasen	(Straßen)	(1 times)
Strorße	(Straße)	(1 times)
Stubsauger	(Staubsauger)	(1 times)
Stul	(Stuhl)	(3 times)
Stund	(Stunde)	(2 times)
Stundnte	(Stunde)	(1 times)
Tache	(Tasche)	(1 times)
Tadyybär	(Teddybär)	(1 times)
Tager	(Tages)	(1 times)
Tarzächlich	(Tatsächlich)	(1 times)
Tasch	(Tasche)	(28 times)
Tascle	(Tasche)	(1 times)
Tatsechlich	(Tatsächlich)	(1 times)
Teddybear	(Teddybär)	(1 times)
Teddyberen	(Teddybären)	(1 times)
Tedibär	(Teddybär)	(3 times)
Tedybär	(Teddybär)	(5 times)
Tedyyberen	(Teddybären)	(1 times)
Tefefonnummer	(Telefonnummer)	(1 times)
Tehlefon	(Telefon)	(1 times)
Tehma	(Thema)	(1 times)
Teisch	(Teich)	(3 times)
Teke	(Theke)	(1 times)
Telefan	(Telefon)	(1 times)
Telefhonnummer	(Telefonnummer)	(1 times)
Telefohn	(Telefon)	(4 times)
Telefohnnummer	(Telefonnummer)	(1 times)
TelefonNumer	(Telefonnummer)	(1 times)
Telefonn	(Telefon)	(1 times)
Telefonnumer	(Telefonnummer)	(14 times)
Telefonnumme	(Telefonnummer)	(1 times)
Telefonselle	(Telefonzelle)	(1 times)
Telefonumer	(Telefonnummer)	(2 times)
Telefphon	(Telefon)	(1 times)
Telefun	(Telefon)	(2 times)
Telepfon	(Telefon)	(3 times)
Telephon	(Telefon)	(4 times)
Telepone	(Telefon)	(1 times)
Televon	(Telefon)	(3 times)
Telfon	(Telefon)	(1 times)
Telfonnummer	(Telefonnummer)	(1 times)
Tellefon	(Telefon)	(2 times)
Tellefonanumer	(Telefonnummer)	(1 times)
Tellefonn	(Telefon)	(1 times)
Tellefonnummer	(Telefonnummer)	(1 times)
Tellevon	(Telefon)	(1 times)
Telofan	(Telefon)	(1 times)
Telofon	(Telefon)	(3 times)
Telofonnumer	(Telefonnummer)	(1 times)
Tema	(Thema)	(1 times)
Tenster	(Fenster)	(1 times)
Tepich	(Teppich)	(2 times)
Tich	(Tisch)	(4 times)
Ties	(Tier)	(1 times)
Tiesch	(Tisch)	(1 times)
Tirartzt	(Tierarzt)	(1 times)
Tirarzt	(Tierarzt)	(1 times)
Tire	(Tiere)	(1 times)
Tlefoen	(Telefon)	(1 times)
Tolette	(Toilette)	(1 times)
Tor	(Tür)	(1 times)
Torm	(Turm)	(1 times)
Traurich	(Traurig)	(1 times)
Traurich	(traurig)	(1 times)
Traurik	(traurig)	(1 times)
Trenen	(Tränen)	(10 times)
Trotztim	(Trotzdem)	(1 times)
Troz	(Trotz)	(1 times)
Tschüß	(Tschüss)	(3 times)
Tur	(Tür)	(4 times)
Turmm	(Turm)	(4 times)
Turn	(Turm)	(1 times)
Täddy	(Teddy)	(2 times)
Tör	(Tür)	(1 times)
Tühr	(Tür)	(3 times)
Türm	(Turm)	(3 times)
Uberaschung	(Überraschung)	(1 times)
Uberrascht	(überrascht)	(1 times)
Uberraschug	(Überraschung)	(1 times)
Uberraschung	(Überraschung)	(3 times)
Uhrplözlich	(urplötzlich)	(1 times)
Umd	(Und)	(1 times)
Un	(Und)	(4 times)
Und-	(Und)	(1 times)
Undd	(Und)	(1 times)
Ungefär	(Ungefähr)	(1 times)
Unt	(Und)	(1 times)
Untericht	(Unterricht)	(8 times)
Unterischt	(Unterricht)	(1 times)
Unterrecht	(Unterricht)	(1 times)
Urgendwie	(irgendwie)	(1 times)
Vehrkauferin	(Verkäuferin)	(1 times)
Venster	(Fenster)	(1 times)
Verande	(Veranda)	(1 times)
Vergesen	(vergessen)	(1 times)
Vergesener	(Vergessener)	(1 times)
Verlorende	(verlorene)	(2 times)
Verlorne	(verlorene)	(2 times)
Vermist	(Vermisst)	(2 times)
Vermiste	(vermisste)	(1 times)
Verwurdert	(Verwundert)	(1 times)
Voge	(Vogel)	(2 times)
VogenL	(Vogel)	(1 times)
Vogl	(Vogel)	(2 times)
Vud	(Und)	(1 times)
WIEDE	(WIEDER)	(1 times)
Wandt	(Wand)	(1 times)
Wanile	(Vanille)	(1 times)
Want	(Wand)	(1 times)
War	(Was)	(1 times)
Warheit	(Wahrheit)	(1 times)
Waser	(Wasser)	(2 times)
Wassa	(Wasser)	(2 times)
Wasserfahl	(Wasserfall)	(1 times)
Weckgehlaufen	(weggelaufen)	(1 times)
WeiJel	(weil)	(1 times)
Weill	(Weil)	(3 times)
Weist	(Weißt)	(2 times)
Wek	(Weg)	(2 times)
Wen	(Wenn)	(4 times)
Wende	(Wände)	(2 times)
Werend	(Während)	(2 times)
Werloren	(verloren)	(1 times)
Wieg	(Wie)	(1 times)
Wieleicht	(Vielleicht)	(1 times)
Wiesse	(Wiese)	(1 times)
Wilst	(Willst)	(1 times)
Wise	(Wiese)	(1 times)
Wisse	(Wiese)	(1 times)
Wohnog	(Wohnung)	(2 times)
Wohnug	(Wohnung)	(1 times)
Wohnzemmer	(Wohnzimmer)	(1 times)
Wonung	(Wohnung)	(5 times)
Wonzimer	(Wohnzimmer)	(1 times)
Wonzimmer	(Wohnzimmer)	(1 times)
Wrosch	(Frosch)	(2 times)
Wärend	(Während)	(1 times)
Würklich	(Wirklich)	(1 times)
Yenau	(Genau)	(1 times)
Zastörte	(zerstörte)	(1 times)
Zimer	(Zimmer)	(4 times)
Zimlick	(Ziemlich)	(1 times)
Zitrune	(Zitrone)	(1 times)
Zuletz	(Zuletzt)	(1 times)
Zurük	(zurück)	(1 times)
Zusahmen	(Zusammen)	(1 times)
Zwichendursch	(Zwischendurch)	(1 times)
a	(an)	(2 times)
aas	(das)	(1 times)
abar	(aber)	(1 times)
abba	(aber)	(2 times)
abe	(aber)	(1 times)
abehaun	(abgehauen)	(1 times)
abeiten	(arbeiten)	(1 times)
abens	(abends)	(1 times)
abet	(aber)	(1 times)
abgeharte	(abgewartet)	(1 times)
abgehgehben	(abgegeben)	(1 times)
abgerisen	(abgerissen)	(1 times)
abgestürts	(abgestürzt)	(1 times)
abgipt	(abgibt)	(1 times)
abhaun	(abhauen)	(1 times)
abholln	(abholen)	(1 times)
abr	(aber)	(2 times)
absand	(Abstand)	(1 times)
ader	(aber)	(2 times)
adrese	(Adresse)	(4 times)
aegenzeitig	(gegenseitig)	(1 times)
aein	(ein)	(2 times)
ahben	(haben)	(1 times)
ahle	(alle)	(1 times)
ahn	(an)	(1 times)
ahngerufen	(angerufen)	(1 times)
ahnruft	(anruft)	(1 times)
ale	(Alle)	(1 times)
ale	(alle)	(13 times)
alein	(allein)	(3 times)
aleine	(alleine)	(6 times)
aler	(aber)	(1 times)
ales	(Alles)	(1 times)
ales	(alles)	(20 times)
all	(alle)	(1 times)
allen	(allein)	(1 times)
alls	(als)	(6 times)
allte	(alte)	(1 times)
alsu	(also)	(1 times)
altere	(ältere)	(1 times)
alz	(als)	(5 times)
ameisten	(meisten)	(1 times)
amf	(auf)	(1 times)
amfang	(Anfang)	(1 times)
and	(an)	(3 times)
and	(und)	(5 times)
andaren	(anderen)	(2 times)
andauernt	(andauernd)	(1 times)
andereres	(anderes)	(1 times)
andre	(andere)	(3 times)
andren	(anderen)	(2 times)
andwort	(Antwort)	(2 times)
andwortet	(antwortet)	(1 times)
aneinnander	(aneinander)	(1 times)
aneruffen	(angerufen)	(1 times)
anfengt	(anfängt)	(1 times)
anfeufft	(anruft)	(1 times)
angeLomen	(angekommen)	(1 times)
angeckomen	(angekommen)	(1 times)
angeckommen	(angekommen)	(1 times)
angegomen	(angekommen)	(1 times)
angekomen	(angekommen)	(4 times)
angeommen	(angekommen)	(1 times)
angerand	(angerannt)	(2 times)
angerifen	(angerufen)	(1 times)
angerofen	(angerufen)	(1 times)
angerrufen	(angerufen)	(1 times)
angeruten	(angerufen)	(1 times)
angrufen	(angerufen)	(1 times)
angstwol	(angstvoll)	(1 times)
anhelt	(anhält)	(2 times)
ankammen	(ankamen)	(1 times)
ankarm	(ankam)	(1 times)
ankekommen	(angekommen)	(1 times)
ankerufen	(angerufen)	(1 times)
ankst	(Angst)	(1 times)
anmal	(einmal)	(3 times)
ann	(an)	(1 times)
anns	(ans)	(2 times)
anrruf	(Anruf)	(1 times)
anrufd	(anruft)	(1 times)
anruff	(Anruf)	(1 times)
anruffen	(anrufen)	(1 times)
anruhf	(Anruf)	(2 times)
anruhft	(anruft)	(1 times)
anrut	(anruft)	(1 times)
anschlisend	(anschließend)	(1 times)
anseige	(Anzeige)	(1 times)
anst	(Angst)	(2 times)
antfortette	(antwortete)	(1 times)
anung	(Ahnung)	(4 times)
anungloss	(ahnungslos)	(1 times)
anwing	(anfing)	(1 times)
anz	(an)	(1 times)
anz	(ans)	(1 times)
ap	(ab)	(3 times)
aper	(aber)	(2 times)
aphaun	(abhauen)	(1 times)
arber	(aber)	(2 times)
armme	(Arme)	(1 times)
arschroken	(erschrocken)	(1 times)
as	(aus)	(1 times)
aschrak	(erschrak)	(1 times)
atwas	(etwas)	(1 times)
au	(auf)	(1 times)
auch-	(auch)	(1 times)
auck	(auch)	(2 times)
auf-	(auf)	(2 times)
aufSchreiden	(aufschreiben)	(1 times)
aufachte	(aufwachte)	(1 times)
aufgade	(Aufgabe)	(1 times)
aufgefahlen	(aufgefallen)	(1 times)
aufgefahllen	(aufgefallen)	(1 times)
aufgeh.passt	(aufgepasst)	(1 times)
aufgehangt	(aufgehängt)	(1 times)
aufgehengt	(aufgehängt)	(2 times)
aufgehhängt	(aufgehängt)	(1 times)
aufgehstanden	(aufgestanden)	(2 times)
aufgemachnd	(aufgemacht)	(1 times)
aufgemmacht	(aufgemacht)	(1 times)
aufgengt	(aufgehängt)	(1 times)
aufgepast	(aufgepasst)	(3 times)
aufgereckt	(aufgeregt)	(1 times)
aufgerekt	(aufgeregt)	(2 times)
aufgerhkt	(aufgeregt)	(1 times)
aufgeschdandenn	(aufgestanden)	(1 times)
aufgeschprungen	(aufgesprungen)	(1 times)
aufgestahnden	(aufgestanden)	(1 times)
aufhengen	(Aufhängen)	(1 times)
aufhengen	(aufhängen)	(2 times)
aufhoren	(aufhören)	(1 times)
aufhörn	(aufhören)	(1 times)
aufpast	(aufpasst)	(1 times)
auft	(auf)	(1 times)
auftn	(auf)	(1 times)
aufzuhengen	(aufzuhängen)	(2 times)
aufzuschreilen	(aufzuschreiben)	(1 times)
aufzusten	(aufzustehen)	(2 times)
augehengt	(aufgehängt)	(1 times)
auh	(auch)	(4 times)
aulz	(als)	(1 times)
aum	(um)	(1 times)
aus	(Haus)	(1 times)
aus-	(aus)	(2 times)
ausbrobirt	(ausprobiert)	(1 times)
ause	(aus)	(1 times)
ausf	(auf)	(1 times)
ausgbrochen	(ausgebrochen)	(1 times)
ausgehstiegen	(ausgestiegen)	(1 times)
ausgerutcht	(ausgerutscht)	(1 times)
ausgeschtigen	(ausgestiegen)	(2 times)
ausgesehn	(ausgesehen)	(1 times)
ausgestieben	(ausgestiegen)	(1 times)
ausgestigen	(ausgestiegen)	(6 times)
ausicht	(Aussicht)	(1 times)
ausieht	(aussieht)	(1 times)
auslern	(ausleeren)	(1 times)
auslerrgen	(ausleeren)	(1 times)
ausnamsweise	(ausnahmsweise)	(1 times)
ausrichden	(ausrichten)	(1 times)
auss	(aus)	(2 times)
ausschteigen	(aussteigen)	(1 times)
ausser	(außer)	(1 times)
aussied	(aussieht)	(1 times)
aussiet	(aussieht)	(1 times)
aussiht	(aussieht)	(1 times)
ausstaign	(aussteigen)	(1 times)
ausstgeigen	(aussteigen)	(1 times)
austeigen	(aussteigen)	(6 times)
auszieht	(aussieht)	(1 times)
auszurun	(auszuruhen)	(1 times)
auß	(aus)	(1 times)
außsteigen	(aussteigen)	(1 times)
awf	(auf)	(3 times)
aws	(aus)	(1 times)
baar	(paar)	(1 times)
baei	(bei)	(1 times)
bai	(bei)	(1 times)
bann	(dann)	(2 times)
barsiert	(passiert)	(1 times)
basiert	(passiert)	(2 times)
basierte	(passierte)	(2 times)
basirte	(passierte)	(1 times)
baues	(bauen)	(1 times)
bauhen	(bauen)	(2 times)
bauwen	(bauen)	(1 times)
becKommen	(bekommen)	(1 times)
becheftigt	(beschäftigt)	(1 times)
beckam	(bekam)	(7 times)
beckomen	(bekommen)	(1 times)
beckomme	(bekomme)	(1 times)
beckommen	(bekommen)	(3 times)
beckomt	(bekommt)	(1 times)
bedancken	(bedanken)	(1 times)
bedangde	(bedankte)	(1 times)
bedannkt	(bedankt)	(1 times)
beemerckt	(bemerkt)	(1 times)
befastigt	(befestigt)	(1 times)
befegt	(bewegt)	(1 times)
befersdigen	(befestigen)	(1 times)
befesdigt	(befestigt)	(1 times)
befestickte	(befestigte)	(1 times)
befestikt	(befestigt)	(1 times)
befesttig	(befestigt)	(1 times)
befor	(bevor)	(3 times)
befästigt	(befestigt)	(4 times)
began	(begann)	(1 times)
begang	(begann)	(2 times)
beginen	(beginnen)	(2 times)
begingen	(beginnen)	(1 times)
beginnnen	(beginnen)	(1 times)
begint	(beginnt)	(1 times)
begonen	(begonnen)	(3 times)
begrif	(begriff)	(1 times)
begrust	(begrüßt)	(1 times)
begrüsen	(begrüßen)	(1 times)
begrüste	(begrüßte)	(1 times)
behahalte	(behalte)	(1 times)
behindet	(behindert)	(1 times)
behrschen	(beherrschen)	(1 times)
behrührt	(berührt)	(1 times)
beiben	(bleiben)	(1 times)
beid	(beide)	(1 times)
beil	(bei)	(1 times)
beilen	(beeilen)	(1 times)
bein	(bei)	(1 times)
bein	(beim)	(1 times)
beinden	(beiden)	(1 times)
beischbiel	(Beispiel)	(1 times)
bekahm	(bekam)	(1 times)
bekamm	(bekam)	(4 times)
bekan	(bekam)	(1 times)
bekome	(bekomme)	(1 times)
bekomen	(bekommen)	(16 times)
bekomt	(bekommt)	(7 times)
bekonen	(bekommen)	(3 times)
belln	(bellen)	(1 times)
belt	(bellt)	(17 times)
belte	(bellte)	(3 times)
bemerckt	(bemerkt)	(2 times)
bemergt	(bemerkt)	(2 times)
bemärgt	(bemerkt)	(1 times)
ben	(den)	(1 times)
benk	(denk)	(1 times)
benuzt	(benutzt)	(1 times)
ber	(aber)	(1 times)
ber	(der)	(1 times)
bereit's	(bereits)	(2 times)
berhugten	(beruhigten)	(1 times)
berllt	(bellt)	(1 times)
beschefdigt	(beschäftigt)	(1 times)
bescheftigt	(beschäftigt)	(1 times)
bescheit	(Bescheid)	(3 times)
bescheit-	(Bescheid)	(1 times)
beschftigt	(beschäftigt)	(1 times)
beschlos	(beschloss)	(1 times)
beschlosen	(beschlossen)	(1 times)
beschloß	(beschloss)	(1 times)
besehr	(besser)	(1 times)
beser	(besser)	(3 times)
besietzer	(Besitzer)	(1 times)
besorkt	(besorgt)	(1 times)
best	(beste)	(1 times)
bestelen	(bestellen)	(1 times)
bestimt	(bestimmt)	(8 times)
bestint	(bestimmt)	(1 times)
bestumt	(bestimmt)	(1 times)
besuh	(Besuch)	(1 times)
beultel	(Beutel)	(1 times)
beutell	(Beutel)	(1 times)
beware	(bewahre)	(1 times)
bewaren	(bewahren)	(1 times)
beweckte	(bewegte)	(1 times)
bewekt	(bewegt)	(2 times)
bewogt	(bewegt)	(1 times)
bewoner	(Bewohner)	(1 times)
bewor	(bevor)	(1 times)
bezitzerin	(Besitzerin)	(1 times)
beängstigent	(beängstigend)	(1 times)
bie	(bei)	(3 times)
biei	(bei)	(1 times)
bield	(Bild)	(2 times)
bies	(bis)	(6 times)
bieschen	(bisschen)	(1 times)
biest	(bist)	(2 times)
biete	(bitte)	(2 times)
bingt	(bringt)	(1 times)
birngt	(bringt)	(1 times)
biro	(Büro)	(1 times)
bis	(bist)	(4 times)
bischeen	(bisschen)	(1 times)
bischen	(bisschen)	(20 times)
bischien	(bisschen)	(1 times)
bisitzerin	(Besitzerin)	(1 times)
biss	(bis)	(8 times)
bissch	(bisschen)	(2 times)
bisshen	(bisschen)	(1 times)
bist	(bis)	(1 times)
bistimt	(bestimmt)	(2 times)
bite	(bitte)	(6 times)
bitt	(bitte)	(2 times)
bißchen	(bisschen)	(1 times)
bkam	(bekam)	(1 times)
blakate	(Plakate)	(2 times)
blarkarte	(Plakate)	(1 times)
bleb	(bleib)	(1 times)
bleit	(bleibt)	(1 times)
blendent	(blendend)	(2 times)
bletter	(Blätter)	(1 times)
blib	(blieb)	(2 times)
bliken	(blicken)	(1 times)
blleter	(Blätter)	(1 times)
bracht	(brachte)	(1 times)
braune-	(braune)	(1 times)
brcht	(bricht)	(1 times)
brengen	(bringen)	(2 times)
briegen	(bringen)	(1 times)
briengt	(bringt)	(1 times)
brig	(bring)	(2 times)
brige	(bringe)	(2 times)
brigen	(bringen)	(1 times)
brigt	(bringt)	(1 times)
briingst	(bringst)	(1 times)
bringd	(bringt)	(1 times)
brink	(bring)	(1 times)
brinkt	(bringt)	(2 times)
brülen	(brüllen)	(1 times)
brült	(brüllt)	(1 times)
bscheftigt	(beschäftigt)	(1 times)
bschreibt	(beschreibt)	(1 times)
buen	(bauen)	(1 times)
burk	(Burg)	(1 times)
buss	(Bus)	(1 times)
bällen	(bellen)	(1 times)
bäutel	(Beutel)	(1 times)
böltel	(Beutel)	(1 times)
böre	(böse)	(1 times)
büse	(böse)	(1 times)
cake	(Jacke)	(1 times)
caufen	(kaufen)	(1 times)
cha	(ja)	(1 times)
chaben	(haben)	(2 times)
chat	(hat)	(5 times)
cher	(her)	(2 times)
chnel	(schnell)	(1 times)
chon	(schon)	(1 times)
ckisde	(Kiste)	(1 times)
ckiste	(Kiste)	(1 times)
da	(das)	(2 times)
daabei	(dabei)	(1 times)
daan	(dann)	(3 times)
dabai	(dabei)	(1 times)
dabe	(dabei)	(1 times)
dabeie	(dabei)	(1 times)
dabeiy	(dabei)	(1 times)
dach	(doch)	(1 times)
dach	(nach)	(2 times)
dachde	(dachte)	(2 times)
dache	(dachte)	(1 times)
dachin	(dahin)	(1 times)
dacht	(dachte)	(1 times)
dadchte	(dachte)	(1 times)
dadzu	(dazu)	(1 times)
dafon	(davon)	(2 times)
dah	(da)	(2 times)
dahnn	(dann)	(1 times)
dakel	(Dackel)	(1 times)
daken	(danken)	(1 times)
dakeschön	(dankeschön)	(1 times)
damid	(damit)	(1 times)
dammit	(damit)	(1 times)
dan	(dann)	(102 times)
danch	(danach)	(2 times)
danck	(Dank)	(1 times)
daneeben	(daneben)	(1 times)
danelem	(daneben)	(1 times)
dange	(danke)	(2 times)
dangt	(dankt)	(1 times)
danit	(damit)	(1 times)
dank	(danke)	(1 times)
dankar	(dankbar)	(1 times)
danker	(danke)	(1 times)
dannach	(danach)	(6 times)
dannke	(danke)	(1 times)
dar	(da)	(12 times)
dar	(das)	(4 times)
daram	(daran)	(1 times)
darausen	(draußen)	(2 times)
darbei	(dabei)	(3 times)
darfs	(darfst)	(1 times)
darfür	(dafür)	(1 times)
darke	(danke)	(1 times)
daruber	(darüber)	(2 times)
daruf	(darauf)	(1 times)
darun	(daran)	(1 times)
das	(da)	(2 times)
das	(dass)	(250 times)
dase	(dass)	(1 times)
dasrauf	(darauf)	(1 times)
dass	(Das)	(1 times)
dass	(das)	(36 times)
daswegen	(deswegen)	(2 times)
dauen	(bauen)	(1 times)
dauuste	(dauerte)	(1 times)
dawohon	(davon)	(1 times)
de	(der)	(1 times)
deann	(dann)	(1 times)
deb	(den)	(1 times)
dedacht	(gedacht)	(1 times)
dedankt	(bedankt)	(1 times)
deen	(den)	(2 times)
degrüßen	(begrüßen)	(1 times)
dehn	(den)	(1 times)
dehsalb	(deshalb)	(1 times)
dei	(bei)	(4 times)
deide	(beide)	(1 times)
dein	(den)	(1 times)
dellt	(bellt)	(1 times)
dem-	(dem)	(1 times)
demm	(dem)	(2 times)
den	(denn)	(68 times)
denck	(denk)	(2 times)
denen	(deinen)	(1 times)
denn	(den)	(73 times)
dens	(den)	(1 times)
der-	(der)	(1 times)
dereckt	(direkt)	(1 times)
derkekt	(direkt)	(1 times)
dern	(den)	(1 times)
des	(das)	(2 times)
deuldlih	(deutlich)	(1 times)
di	(da)	(1 times)
di	(die)	(8 times)
dicht	(nicht)	(1 times)
diech	(dich)	(3 times)
diecken	(dicken)	(3 times)
diee	(die)	(1 times)
dieken	(dicken)	(2 times)
dien	(den)	(1 times)
dier	(dir)	(8 times)
dierekt	(direkt)	(2 times)
diesma	(diesmal)	(1 times)
dihr	(dir)	(1 times)
din	(ein)	(1 times)
direck	(direkt)	(2 times)
direckt	(direkt)	(1 times)
diregt	(direkt)	(1 times)
dis	(bis)	(2 times)
disen	(diesen)	(7 times)
dises	(dieses)	(1 times)
disses	(dieses)	(1 times)
dist	(bist)	(1 times)
dm	(dem)	(2 times)
dmit	(damit)	(1 times)
dn	(den)	(1 times)
dnd	(und)	(1 times)
do	(da)	(3 times)
docch	(doch)	(1 times)
doden	(Boden)	(1 times)
doe	(die)	(1 times)
doff	(doof)	(1 times)
dol	(doll)	(8 times)
dole	(doll)	(2 times)
dolle	(doll)	(3 times)
dooktor	(Doktor)	(1 times)
dor	(dort)	(1 times)
dord	(dort)	(2 times)
dorften	(durften)	(1 times)
dos	(das)	(1 times)
draf	(drauf)	(2 times)
drane	(dran)	(3 times)
drarußen	(draußen)	(1 times)
drau	(drauf)	(1 times)
draufen	(draußen)	(1 times)
draurig	(traurig)	(1 times)
drausen	(draußen)	(49 times)
draussen	(draußen)	(3 times)
drek	(Dreck)	(1 times)
drekig	(dreckig)	(1 times)
drekt	(direkt)	(2 times)
dret	(dreht)	(1 times)
drete	(drehte)	(3 times)
drien	(drin)	(1 times)
driene	(drin)	(2 times)
drine	(drin)	(9 times)
drinen	(drinnen)	(10 times)
drinn	(drin)	(2 times)
drinne	(drinnen)	(5 times)
drite	(dritte)	(2 times)
druckte	(drückte)	(1 times)
drustete	(tröstete)	(1 times)
ds	(das)	(1 times)
dsiser	(dieser)	(1 times)
duch	(durch)	(5 times)
duchs	(durchs)	(2 times)
duf	(auf)	(1 times)
duich	(durch)	(1 times)
dumet	(damit)	(1 times)
dunke	(danke)	(1 times)
durft	(dürft)	(1 times)
dus	(das)	(1 times)
dusch	(durch)	(1 times)
dw	(du)	(1 times)
dwrch	(durch)	(2 times)
dänkt	(denkt)	(1 times)
dörfen	(dürfen)	(2 times)
düfen	(dürfen)	(1 times)
ebenfals	(ebenfalls)	(2 times)
ebensfals	(ebenfalls)	(1 times)
ecbloson	(Explosion)	(1 times)
eckstra	(extra)	(1 times)
edem	(dem)	(1 times)
eder	(der)	(1 times)
ef	(er)	(1 times)
egendwas	(irgendwas)	(1 times)
egentwo	(irgendwo)	(1 times)
eggal	(egal)	(1 times)
egsploson	(Explosion)	(1 times)
egstra	(extra)	(1 times)
ehr	(er)	(2 times)
ei	(ein)	(3 times)
eie	(ein)	(1 times)
eien	(eine)	(1 times)
eiene	(eine)	(1 times)
eienen	(einen)	(1 times)
eigenlich	(eigentlich)	(1 times)
eigentich	(eigentlich)	(1 times)
eihnen	(einen)	(1 times)
eim	(ein)	(3 times)
eima	(einmal)	(1 times)
eimal	(einmal)	(15 times)
eime	(eine)	(2 times)
eimen	(einen)	(1 times)
ein	(in)	(1 times)
eineholt	(eingeholt)	(1 times)
einein	(einen)	(1 times)
eineir	(einer)	(1 times)
einenen	(einen)	(2 times)
einerr	(einer)	(1 times)
einfahch	(einfach)	(1 times)
einfahr	(einfach)	(1 times)
einfar	(einfach)	(1 times)
einfch-	(einfach)	(1 times)
einfehlt	(einfällt)	(1 times)
einferstanden	(einverstanden)	(1 times)
einffach	(einfach)	(1 times)
eingehollt	(eingeholt)	(1 times)
eingestigen	(eingestiegen)	(1 times)
einhollen	(einholen)	(3 times)
einkauftasch	(Einkaufstasche)	(1 times)
einmall	(einmal)	(11 times)
einmol	(einmal)	(1 times)
einn	(ein)	(1 times)
einnal	(einmal)	(1 times)
einnen	(einen)	(1 times)
einnes	(Eines)	(1 times)
einr	(einer)	(1 times)
einruft	(anruft)	(1 times)
einsigen	(einzigen)	(1 times)
einwach	(einfach)	(1 times)
einziege	(einzige)	(2 times)
eir	(er)	(1 times)
eirem	(einem)	(1 times)
eise	(eine)	(1 times)
eksplodiert	(explodiert)	(1 times)
en	(den)	(2 times)
enach	(nach)	(1 times)
encklich	(endlich)	(1 times)
ende-	(Ende)	(1 times)
endeckt	(entdeckt)	(2 times)
endschuldigen	(entschuldigen)	(1 times)
endschuldigung	(Entschuldigung)	(1 times)
endsparnt	(entspannt)	(1 times)
enem	(einem)	(2 times)
enen	(einen)	(2 times)
englich	(Endlich)	(1 times)
englich	(endlich)	(1 times)
enklich	(endlich)	(1 times)
enschuldigung	(Entschuldigung)	(1 times)
enschuldikt	(entschuldigt)	(1 times)
entdekt	(entdeckt)	(1 times)
enteckt	(entdeckt)	(1 times)
enteucht	(enttäuscht)	(1 times)
enteuscht	(enttäuscht)	(1 times)
entgehgen	(entgegen)	(1 times)
entglich	(endlich)	(1 times)
entlich	(endlich)	(10 times)
entsetst	(entsetzt)	(1 times)
entteucht	(enttäuscht)	(1 times)
entteuscht	(enttäuscht)	(1 times)
entäuscht	(enttäuscht)	(2 times)
er	(der)	(2 times)
er	(es)	(1 times)
erSchreten	(erschrecken)	(1 times)
erSchroken	(erschrocken)	(1 times)
ereichen	(erreichen)	(2 times)
ereicht	(erreicht)	(3 times)
erenert	(erinnert)	(1 times)
ergendwo	(irgendwo)	(1 times)
ergentwohien	(irgendwohin)	(1 times)
ergert	(ärgert)	(1 times)
erleichtard	(erleichtert)	(1 times)
erleischtert	(erleichtert)	(1 times)
err	(er)	(1 times)
ers	(erst)	(1 times)
ersaunt	(erstaunt)	(1 times)
erschoft	(erschöpft)	(1 times)
erschoken	(erschrocken)	(1 times)
erschrack	(erschrak)	(8 times)
erschrag	(erschrak)	(5 times)
erschrechkt	(erschreckt)	(1 times)
erschregt	(erschreckt)	(2 times)
erschreken	(erschrecken)	(1 times)
erschrekt	(erschreckt)	(11 times)
erschrigt	(erschrickt)	(1 times)
erschrogen	(erschrocken)	(1 times)
erschroken	(erschrocken)	(21 times)
erschrokken	(erschrocken)	(1 times)
erschrolen	(erschrocken)	(1 times)
erschräkt	(erschreckt)	(1 times)
erschröcken	(erschrocken)	(1 times)
erschtaund	(erstaunt)	(1 times)
erschöft	(erschöpft)	(1 times)
ersehe	(Versehen)	(1 times)
ersehen	(Versehen)	(2 times)
erstand	(erstaunt)	(1 times)
erstcaunt	(erstaunt)	(1 times)
erstrocken	(erschrocken)	(1 times)
ervolk	(Erfolg)	(1 times)
erwartungsfoll	(erwartungsvoll)	(1 times)
erwichen	(erwischen)	(1 times)
erwicht	(erwischt)	(3 times)
erwiederte	(erwiderte)	(1 times)
erwist	(erwischt)	(1 times)
erzahld	(erzählt)	(1 times)
esen	(essen)	(6 times)
est	(es)	(1 times)
etlang	(entlang)	(1 times)
etwat	(etwas)	(1 times)
etwos	(etwas)	(1 times)
euch	(auch)	(1 times)
ev	(er)	(1 times)
explodirt	(explodiert)	(1 times)
facht	(wacht)	(1 times)
fagt	(fragt)	(1 times)
fahlen	(fallen)	(1 times)
fahrren	(fahren)	(1 times)
fahrtet	(wartet)	(1 times)
falehn	(fallen)	(1 times)
falen	(fallen)	(9 times)
falln	(fallen)	(1 times)
fals	(falls)	(2 times)
fant	(fand)	(2 times)
farabredet	(verabredet)	(1 times)
faren	(fahren)	(5 times)
farlorene	(verlorene)	(1 times)
farschwundene	(verschwundene)	(1 times)
farten	(warten)	(2 times)
fartikig	(fertig)	(1 times)
farzeug	(Fahrzeug)	(1 times)
fas	(was)	(1 times)
fasst	(fast)	(8 times)
fastsinirt	(fasziniert)	(1 times)
feg	(weg)	(3 times)
feherapredet	(verabredet)	(1 times)
fehloren	(verloren)	(1 times)
fehnster	(Fenster)	(4 times)
fehnsterbank	(Fensterbank)	(1 times)
fehrgesen	(vergessen)	(2 times)
fehrhindert	(verhindert)	(1 times)
fehrlang	(verlangt)	(1 times)
fehrlaufen	(verlaufen)	(1 times)
fehrloren	(verloren)	(1 times)
fehstalten	(festhalten)	(1 times)
feil	(weil)	(7 times)
feiter	(weiter)	(1 times)
fellt	(fällt)	(6 times)
felt	(fehlt)	(2 times)
fengen	(fangen)	(1 times)
fengt	(fängt)	(7 times)
fensder	(Fenster)	(2 times)
fenserbank	(Fensterbank)	(1 times)
fenstehr	(Fenster)	(1 times)
fensterbang	(Fensterbank)	(1 times)
fenzder	(Fenster)	(1 times)
fenzter	(Fenster)	(3 times)
ferSchuden	(verschwunden)	(1 times)
ferabschidet	(verabschiedet)	(1 times)
ferabschideten	(verabschiedeten)	(1 times)
feranstaltet	(veranstaltet)	(1 times)
fercheuche	(verscheuchen)	(1 times)
ferchwunden	(verschwunden)	(1 times)
ferfen	(werfen)	(2 times)
ferfolgen	(verfolgen)	(1 times)
ferfolgt	(verfolgt)	(1 times)
ferfolgt-	(verfolgt)	(1 times)
ferfolkt	(verfolgt)	(1 times)
fergas	(vergaß)	(1 times)
fergaß	(vergaß)	(1 times)
fergesen	(vergessen)	(37 times)
fergesene	(vergessene)	(2 times)
fergessen	(vergessen)	(20 times)
fergist	(vergisst)	(1 times)
ferhindern	(verhindern)	(1 times)
ferhtich	(fertig)	(1 times)
ferigt	(fertig)	(1 times)
ferkessen	(vergessen)	(1 times)
ferkeufer	(Verkäufer)	(1 times)
ferkricht	(verkriecht)	(1 times)
ferletzt	(verletzt)	(3 times)
ferlezt	(verletzt)	(1 times)
ferloen	(verloren)	(1 times)
ferloren	(verloren)	(17 times)
ferlorene	(verlorene)	(5 times)
ferlorn	(verloren)	(1 times)
ferlätzt	(verletzt)	(1 times)
fermiest	(vermisst)	(2 times)
fermise	(vermisse)	(2 times)
fermist	(vermisst)	(17 times)
fermiste	(vermisste)	(1 times)
ferscheuchen	(verscheuchen)	(1 times)
ferscheucht	(verscheucht)	(1 times)
ferschwand	(verschwand)	(3 times)
ferschwuden	(verschwunden)	(1 times)
ferschwunden	(verschwunden)	(20 times)
ferschwundene	(verschwundene)	(2 times)
fersehen	(Versehen)	(7 times)
fersehn	(Versehen)	(1 times)
ferspochen	(versprochen)	(1 times)
fersteckt	(versteckt)	(5 times)
fersteckte	(versteckte)	(1 times)
ferstehen	(verstehen)	(1 times)
ferstehkt	(versteckt)	(1 times)
ferstekt	(versteckt)	(1 times)
fersuch	(Versuch)	(1 times)
fersucht	(versucht)	(18 times)
fersuhte	(versuchte)	(1 times)
fersweifelt	(verzweifelt)	(1 times)
ferteilt	(verteilt)	(1 times)
fertich	(fertig)	(3 times)
fertieft	(vertieft)	(1 times)
fertik	(fertig)	(2 times)
fertrau	(Vertrau)	(1 times)
ferwiert	(verwirrt)	(1 times)
ferwirt	(verwirrt)	(1 times)
ferzeihen	(verzeihen)	(1 times)
ferzweifelt	(verzweifelt)	(1 times)
fesst	(fest)	(1 times)
festalten	(festhalten)	(1 times)
feteilt	(verteilt)	(1 times)
feten	(fetten)	(1 times)
fetig	(fertig)	(1 times)
feude	(Freude)	(2 times)
feut	(freut)	(1 times)
fewar	(war)	(1 times)
fhenster	(Fenster)	(1 times)
fhnster	(Fenster)	(1 times)
fiL	(fiel)	(1 times)
fiartig	(fertig)	(2 times)
fieder	(wieder)	(1 times)
fiel	(viel)	(5 times)
fiele	(viele)	(1 times)
fieleicht	(vielleicht)	(2 times)
fieles	(vieles)	(1 times)
fiell	(fiel)	(1 times)
fiellen	(vielen)	(1 times)
fiendent	(findet)	(1 times)
fienet	(findet)	(1 times)
fil	(fiel)	(4 times)
fill	(fiel)	(1 times)
fill	(will)	(1 times)
findes	(findest)	(1 times)
fliehn	(fliehen)	(1 times)
fligen	(fliegen)	(3 times)
fligt	(fliegt)	(5 times)
flikt	(fliegt)	(2 times)
flok	(flog)	(1 times)
flug	(flog)	(1 times)
fluhr	(Flur)	(1 times)
flus	(Fluss)	(2 times)
flutst	(flutscht)	(1 times)
fnster	(Fenster)	(1 times)
fogel	(Vogel)	(7 times)
foler	(voller)	(1 times)
folkt	(folgt)	(2 times)
foll	(voll)	(7 times)
foller	(Voller)	(1 times)
fom	(vom)	(11 times)
fon	(von)	(43 times)
fonn	(von)	(1 times)
for	(vor)	(29 times)
forbei	(vorbei)	(9 times)
forbeikommen	(vorbeikommen)	(1 times)
form	(vorm)	(1 times)
forne	(vorne)	(6 times)
forsichtig	(vorsichtig)	(5 times)
fote	(Pfote)	(2 times)
foten	(Pfoten)	(1 times)
fourschwunden	(verschwunden)	(1 times)
frags	(fragt)	(1 times)
fraragte	(fragte)	(1 times)
frate	(fragte)	(1 times)
frauen	(freuen)	(1 times)
fraut	(freut)	(1 times)
freede	(Freude)	(1 times)
freit	(freut)	(2 times)
fresen	(fressen)	(1 times)
fret	(freut)	(2 times)
freud	(freut)	(7 times)
freuhen	(freuen)	(1 times)
freulich	(fröhlich)	(1 times)
freunglich	(freundlich)	(1 times)
frgt	(fragt)	(1 times)
friche	(frische)	(1 times)
friest	(frisst)	(1 times)
fris	(friss)	(1 times)
frist	(frisst)	(22 times)
fro	(froh)	(20 times)
froeit	(freut)	(1 times)
froeunde	(Freunde)	(2 times)
frohlich	(fröhlich)	(4 times)
froho	(froh)	(1 times)
frojt	(freut)	(1 times)
frolich	(fröhlich)	(1 times)
frout	(freut)	(1 times)
froyde	(Freude)	(1 times)
frsucht	(versucht)	(1 times)
frude	(Freude)	(1 times)
fruh	(früh)	(1 times)
fröchlich	(fröhlich)	(1 times)
frölich	(fröhlich)	(25 times)
fröliches	(fröhliches)	(1 times)
frü	(früh)	(1 times)
früen	(frühen)	(1 times)
frühlich	(fröhlich)	(2 times)
frülhoch	(fröhlich)	(1 times)
frülisch	(fröhlich)	(1 times)
fungzuniert	(funktioniert)	(1 times)
funkistonirt	(funktioniert)	(1 times)
fur	(für)	(5 times)
futer	(Futter)	(14 times)
fwr	(für)	(1 times)
fählt	(fällt)	(2 times)
fähren	(fahren)	(1 times)
fäht	(fährt)	(1 times)
fäld	(fällt)	(3 times)
fält	(fällt)	(14 times)
färht	(fährt)	(1 times)
färt	(fährt)	(1 times)
färtich	(fertig)	(1 times)
fästgebunden	(festgebunden)	(1 times)
fölich	(fröhlich)	(1 times)
fölig	(völlig)	(1 times)
fötchen	(Pfötchen)	(1 times)
fü	(für)	(1 times)
füchterlich	(fürchterlich)	(1 times)
fühen	(frühen)	(1 times)
führ	(für)	(2 times)
fülen	(fühlen)	(1 times)
fürsterlich	(fürchterlich)	(1 times)
fütchen	(Pfötchen)	(1 times)
ga	(gar)	(3 times)
gaa	(gar)	(1 times)
gad	(gab)	(1 times)
gafeurt	(gefreut)	(1 times)
gahb	(gab)	(1 times)
gahsi	(Gassi)	(1 times)
gaht	(geht)	(1 times)
gam	(kam)	(2 times)
gamen	(kamen)	(1 times)
gan	(ganz)	(1 times)
gane	(ganz)	(1 times)
gann	(kann)	(1 times)
gannse	(ganze)	(1 times)
gans	(ganz)	(24 times)
ganse	(ganze)	(6 times)
gansen	(ganzen)	(1 times)
gansse	(ganze)	(1 times)
gantz	(ganz)	(6 times)
gantze	(ganze)	(2 times)
ganzt	(ganz)	(1 times)
ganß	(ganz)	(1 times)
gap	(gab)	(1 times)
garade	(gerade)	(1 times)
garb	(gab)	(1 times)
garn	(gar)	(1 times)
gasi	(Gassi)	(3 times)
gassie	(Gassi)	(2 times)
gat	(gar)	(1 times)
gaze	(ganze)	(1 times)
geStaugt	(gesaugt)	(1 times)
geStolpat	(gestolpert)	(1 times)
geangen	(gegangen)	(1 times)
geb	(gebe)	(1 times)
gebanken	(Gedanken)	(1 times)
gebat	(gebaut)	(1 times)
gebelt	(gebellt)	(5 times)
geblatzt	(geplatzt)	(1 times)
gebliben	(geblieben)	(3 times)
gebliden	(geblieben)	(1 times)
gebrach	(gebracht)	(4 times)
gebrat	(gebracht)	(1 times)
geburstag	(Geburtstag)	(2 times)
gebutstag	(Geburtstag)	(1 times)
gechapt	(gehabt)	(1 times)
gechen	(gehen)	(1 times)
gecheng	(Geschenk)	(1 times)
gechenk	(Geschenk)	(1 times)
gechischte	(Geschichte)	(1 times)
gechprungen	(gesprungen)	(1 times)
gecht	(geht)	(2 times)
gechört	(gehört)	(1 times)
geckangen	(gegangen)	(1 times)
geckauft	(gekauft)	(2 times)
gecklaut	(geklaut)	(1 times)
geckommen	(gekommen)	(1 times)
geden	(geben)	(1 times)
gedruckt	(gedrückt)	(1 times)
gedrügt	(gedrückt)	(1 times)
geduldigt	(geduldig)	(1 times)
geemacht	(gemacht)	(1 times)
gef=unden	(gefunden)	(1 times)
gefahlen	(gefallen)	(4 times)
gefalen	(gefallen)	(26 times)
gefalln	(gefallen)	(2 times)
gefaln	(gefallen)	(1 times)
gefanden	(gefunden)	(1 times)
gefaren	(gefahren)	(4 times)
gefast	(gefasst)	(1 times)
gefeind	(geweint)	(1 times)
gefeld	(gefehlt)	(1 times)
gefelt	(gefällt)	(3 times)
geffalen	(gefallen)	(3 times)
geffallen	(gefallen)	(1 times)
geffeurt	(gefreut)	(1 times)
geffunden	(gefunden)	(1 times)
gefohnden	(gefunden)	(1 times)
geforden	(geworden)	(1 times)
geforfen	(geworfen)	(1 times)
gefracht	(gefragt)	(1 times)
gefrag	(gefragt)	(1 times)
gefreud	(gefreut)	(3 times)
gefreund	(gefreut)	(1 times)
gefreßen	(gefressen)	(1 times)
gefrofen	(getroffen)	(1 times)
gefroit	(gefreut)	(1 times)
gefrojt	(gefreut)	(1 times)
gefrut	(gefreut)	(1 times)
gefrät	(gefreut)	(1 times)
gefründt	(gefreut)	(1 times)
gefuden	(gefunden)	(3 times)
gefund	(gefunden)	(4 times)
gefunde	(gefunden)	(3 times)
gefunen	(gefunden)	(3 times)
gefunten	(gefunden)	(1 times)
gefurten	(gefunden)	(1 times)
gefönden	(gefunden)	(1 times)
gefül	(Gefühl)	(3 times)
gefült	(gefüllt)	(1 times)
gegagen	(gegangen)	(1 times)
gegancken	(gegangen)	(1 times)
geganden	(gegangen)	(1 times)
geganen	(gegangen)	(2 times)
gegang	(gegangen)	(1 times)
gegange	(gegangen)	(2 times)
gegannen	(gegangen)	(3 times)
gegeden	(gegeben)	(1 times)
gegegesen	(gegessen)	(1 times)
gegen	(gehen)	(2 times)
gegend	(gegen)	(1 times)
gegendt	(gegen)	(1 times)
gegeneinanda	(gegeneinander)	(1 times)
gegesen	(gegessen)	(2 times)
gegiben	(gegeben)	(1 times)
gegkommen	(gekommen)	(1 times)
geglingelnd	(geklingelt)	(1 times)
geglingelt	(geklingelt)	(1 times)
gegngen	(gegangen)	(1 times)
gegomen	(gekommen)	(1 times)
gegrüst	(gegrüßt)	(1 times)
gehabd	(gehabt)	(1 times)
gehben	(Geben)	(1 times)
gehdacht	(gedacht)	(1 times)
gehefalen	(gefallen)	(2 times)
gehegeheben	(gegeben)	(1 times)
geheimnlis	(Geheimnis)	(1 times)
gehekomen	(gekommen)	(1 times)
gehen-	(gehen)	(1 times)
gehet	(geht)	(4 times)
gehfahr	(Gefahr)	(1 times)
gehfalen	(gefallen)	(1 times)
gehfallen	(gefallen)	(1 times)
gehfunden	(gefunden)	(2 times)
gehgahngen	(gegangen)	(1 times)
gehgangehn	(gegangen)	(1 times)
gehgangen	(gegangen)	(9 times)
gehgehn	(gegen)	(1 times)
gehhabt	(gehabt)	(1 times)
gehholt	(geholt)	(1 times)
gehhört	(gehört)	(1 times)
gehin	(gehen)	(1 times)
gehlacht	(gelacht)	(1 times)
gehlaufen	(gelaufen)	(3 times)
gehlekt	(gelegt)	(1 times)
gehmacht	(gemacht)	(2 times)
gehmaht	(gemacht)	(1 times)
gehmensem	(gemeinsam)	(1 times)
gehmergt	(gemerkt)	(1 times)
gehn	(gehen)	(4 times)
gehnohmen	(genommen)	(1 times)
gehold	(geholt)	(1 times)
gehollt	(geholt)	(1 times)
gehort	(gehört)	(6 times)
gehrade	(gerade)	(2 times)
gehrant	(gerannt)	(1 times)
gehsagt	(gesagt)	(4 times)
gehsehen	(gesehen)	(14 times)
gehsehn	(gesehen)	(4 times)
gehstorben	(gestorben)	(1 times)
gehtarn	(getan)	(1 times)
gehult	(geholt)	(1 times)
gehupft	(gehüpft)	(2 times)
gehurt	(gehört)	(1 times)
gehän	(gehen)	(1 times)
gehörd	(gehört)	(1 times)
gehörte	(gehört)	(1 times)
geibit	(gibt)	(1 times)
geisth	(Geist)	(1 times)
gekanken	(gegangen)	(1 times)
gekaut	(gekauft)	(2 times)
gekilinelt	(geklingelt)	(1 times)
geklept	(geklebt)	(1 times)
geklingeld	(geklingelt)	(1 times)
geklingetlt	(geklingelt)	(1 times)
geklinkelt	(geklingelt)	(1 times)
gekloppft	(geklopft)	(1 times)
geknalt	(geknallt)	(1 times)
gekoft	(geklopft)	(1 times)
gekomen	(gekommen)	(5 times)
gekommem	(gekommen)	(1 times)
gekrabelt	(gekrabbelt)	(1 times)
gekriclt	(gekriegt)	(1 times)
gekriekt	(gekriegt)	(1 times)
gekrigt	(gekriegt)	(1 times)
gekringelt	(geklingelt)	(1 times)
gekuchelt	(gekuschelt)	(1 times)
gelach	(gelacht)	(1 times)
gelanded	(gelandet)	(1 times)
gelanweilt	(gelangweilt)	(1 times)
gelasen	(gelassen)	(3 times)
gelechelt	(gelächelt)	(1 times)
geleichzeitich	(gleichzeitig)	(1 times)
gelet	(gelegt)	(1 times)
geleufen	(gelaufen)	(1 times)
gelmben	(gelben)	(1 times)
geloker	(gelockert)	(1 times)
gelöcklich	(glücklich)	(1 times)
gemach	(gemacht)	(3 times)
gemaht	(gemacht)	(2 times)
gemaldet	(gemeldet)	(1 times)
gemallt	(gemalt)	(1 times)
gemeinsan	(gemeinsam)	(1 times)
gemeisam	(gemeinsam)	(1 times)
gemeldt	(gemeldet)	(1 times)
gemerckt	(gemerkt)	(1 times)
gemerg	(gemerkt)	(1 times)
gemert	(gemerkt)	(1 times)
gemutlich	(gemütlich)	(1 times)
gengen	(gegen)	(1 times)
geniest	(genießt)	(1 times)
genomen	(genommen)	(21 times)
genuch	(genug)	(1 times)
genuk	(genug)	(1 times)
genüslich	(genüsslich)	(1 times)
geousch	(Geräusch)	(1 times)
gerad	(gerade)	(2 times)
gerada	(gerade)	(1 times)
gerand	(gerannt)	(2 times)
gerant	(gerannt)	(18 times)
gerauschen	(Geräuschen)	(1 times)
gerechnete	(gerechnet)	(1 times)
gerechnit	(gerechnet)	(1 times)
gereded	(geredet)	(1 times)
geretet	(gerettet)	(1 times)
gereusch	(Geräusch)	(4 times)
geriesen	(gerissen)	(2 times)
gerissin	(gerissen)	(1 times)
gerit	(geriet)	(1 times)
gerruch	(Geruch)	(1 times)
geruscht	(gerutscht)	(1 times)
geruttscht	(gerutscht)	(1 times)
gesaagt	(gesagt)	(2 times)
gesack	(gesagt)	(1 times)
gesag	(gesagt)	(3 times)
gesaght	(gesagt)	(1 times)
gesahgt	(gesagt)	(1 times)
gesakkt	(gesagt)	(1 times)
gesakt	(gesagt)	(3 times)
gesaukt	(gesaugt)	(1 times)
gescha	(geschah)	(1 times)
geschaft	(geschafft)	(22 times)
geschar	(geschah)	(1 times)
geschbrungen	(gesprungen)	(5 times)
geschemt	(geschämt)	(2 times)
gescheng	(Geschenk)	(1 times)
geschengt	(geschenkt)	(2 times)
geschenk	(geschenkt)	(1 times)
geschieben	(geschrieben)	(1 times)
geschikt	(geschickt)	(1 times)
geschischte	(Geschichte)	(1 times)
geschiste	(Geschichte)	(1 times)
geschnapt	(geschnappt)	(1 times)
geschnupert	(geschnuppert)	(2 times)
geschogt	(geschockt)	(1 times)
geschokt	(geschockt)	(3 times)
geschpielt	(gespielt)	(2 times)
geschprongen	(gesprungen)	(1 times)
geschprugen	(gesprungen)	(1 times)
geschprungen	(gesprungen)	(9 times)
geschreiben	(geschrieben)	(1 times)
geschreibien	(geschrieben)	(1 times)
geschriben	(geschrieben)	(6 times)
geschrim	(geschrien)	(1 times)
geschrin	(geschrien)	(3 times)
geschtolpert	(gestolpert)	(2 times)
geschtorben	(gestorben)	(2 times)
geschwindikeit	(Geschwindigkeit)	(1 times)
geschänk	(Geschenk)	(1 times)
gesechen	(gesehen)	(2 times)
geseh	(gesehen)	(1 times)
gesehe	(gesehen)	(1 times)
gesehn	(gesehen)	(16 times)
gesehon	(gesehen)	(1 times)
geseigt	(gezeigt)	(1 times)
gesgt	(gesagt)	(1 times)
geshockt	(geschockt)	(1 times)
gesogen	(gezogen)	(1 times)
gespand	(gespannt)	(1 times)
gespant	(gespannt)	(5 times)
gespante	(gespannte)	(1 times)
gespiel	(gespielt)	(1 times)
gespild	(gespielt)	(1 times)
gesprun.gen	(gesprungen)	(1 times)
gesprung	(gesprungen)	(1 times)
gesprungn	(gesprungen)	(1 times)
gespungen	(gesprungen)	(1 times)
gessagt	(gesagt)	(1 times)
gesscheng	(Geschenk)	(1 times)
gessehen	(gesehen)	(2 times)
gesteld	(gestellt)	(1 times)
gestelt	(gestellt)	(11 times)
gester	(gestern)	(1 times)
gestigen	(gestiegen)	(4 times)
gestoben	(gestorben)	(2 times)
gestolbart	(gestolpert)	(1 times)
gestolbert	(gestolpert)	(1 times)
gestolper	(gestolpert)	(1 times)
gestopt	(gestoppt)	(1 times)
gestroben	(gestorben)	(1 times)
gesuchd	(gesucht)	(1 times)
get	(geht)	(25 times)
getahn	(getan)	(2 times)
getauert	(gedauert)	(1 times)
geth	(geht)	(1 times)
gethan	(getan)	(1 times)
getofen	(getroffen)	(1 times)
getrofen	(getroffen)	(10 times)
getruken	(getrunken)	(1 times)
gett	(geht)	(1 times)
gettrent	(getrennt)	(1 times)
gettrofen	(getroffen)	(1 times)
gevallen	(gefallen)	(1 times)
gevunden	(gefunden)	(1 times)
gewackeld	(gewackelt)	(1 times)
gewart	(gewarnt)	(1 times)
gewatet	(gewartet)	(4 times)
geweit	(geweint)	(1 times)
gewese	(gewesen)	(1 times)
gewessen	(gewesen)	(1 times)
geworen	(geworden)	(1 times)
gewoten	(geworden)	(1 times)
gewundat	(gewundert)	(1 times)
gewunden	(gefunden)	(4 times)
gewunder	(gewundert)	(1 times)
gewunderd	(gewundert)	(1 times)
gewust	(gewusst)	(1 times)
gezakt	(gesagt)	(1 times)
gezegt	(gezeigt)	(1 times)
gezeickt	(gezeigt)	(1 times)
gezeik	(gezeigt)	(1 times)
gezoge	(gezogen)	(1 times)
geährliche	(gefährliche)	(1 times)
geöfnet	(geöffnet)	(2 times)
gfragt	(gefragt)	(1 times)
gfreut	(gefreut)	(2 times)
gfunden	(gefunden)	(4 times)
ghen	(gehen)	(2 times)
gibs	(gibts)	(1 times)
gieb	(gib)	(2 times)
gieben	(geben)	(1 times)
giebt	(gibt)	(12 times)
gieng	(ging)	(1 times)
gig	(ging)	(1 times)
gigen	(gingen)	(1 times)
gigessen	(gegessen)	(2 times)
gink	(ging)	(1 times)
ginken	(gingen)	(1 times)
ginng	(ging)	(1 times)
gipbi	(gibt)	(1 times)
gipt	(gibt)	(10 times)
glacklich	(glücklich)	(1 times)
glaich	(gleich)	(1 times)
glaiech	(gleich)	(1 times)
glat	(glatt)	(1 times)
glebt	(klebt)	(1 times)
glei	(gleich)	(1 times)
gleisch	(gleich)	(2 times)
glich	(gleich)	(1 times)
glingelt	(klingelt)	(1 times)
gluchlich	(glücklich)	(2 times)
gluck	(Glück)	(4 times)
glucklich	(glücklich)	(9 times)
gluglich	(glücklich)	(1 times)
gluklesch	(glücklich)	(1 times)
gluklich	(glücklich)	(1 times)
glüKlich	(glücklich)	(1 times)
glüchklich	(glücklich)	(1 times)
glüchlich	(glücklich)	(1 times)
glücklic	(glücklich)	(1 times)
glücklig	(glücklich)	(4 times)
glücklisch	(glücklich)	(1 times)
glüglich	(glücklich)	(18 times)
glügliches	(glückliches)	(1 times)
glüglist	(glücklich)	(1 times)
glük	(Glück)	(3 times)
glükclich	(glücklich)	(1 times)
glüklch	(glücklich)	(2 times)
glüklich	(glücklich)	(48 times)
glüklicher	(glücklicher)	(1 times)
glüklieg	(glücklich)	(1 times)
glüklisch	(glücklich)	(1 times)
gmelde	(gemeldet)	(1 times)
gnalte	(knallte)	(1 times)
goschichto	(Geschichte)	(1 times)
gr	(gar)	(1 times)
grabe	(grade)	(1 times)
grgern	(ärgern)	(1 times)
grief	(griff)	(1 times)
grieg	(krieg)	(1 times)
griegst	(kriegst)	(1 times)
grif	(Griff)	(1 times)
grif	(griff)	(1 times)
grin	(drin)	(1 times)
grochen	(gerochen)	(1 times)
grose	(große)	(2 times)
grosen	(großen)	(1 times)
grusliges	(Gruseliges)	(1 times)
grönen	(grünen)	(1 times)
gröser	(größer)	(2 times)
grücken	(drücken)	(1 times)
grücklich	(glücklich)	(1 times)
gsagt	(gesagt)	(1 times)
gscheng	(Geschenk)	(1 times)
gu	(zu)	(1 times)
guab	(gab)	(1 times)
gucgt	(guckt)	(1 times)
gud	(gut)	(1 times)
gugckt	(guckt)	(1 times)
gukt	(guckt)	(1 times)
gukte	(guckte)	(1 times)
gulücklich	(glücklich)	(1 times)
gönau	(genau)	(1 times)
gücklich	(glücklich)	(1 times)
güklich	(glücklich)	(1 times)
gülücklich	(glücklich)	(1 times)
hab	(hat)	(2 times)
haber	(aber)	(1 times)
had	(hat)	(1 times)
hade	(habe)	(5 times)
haden	(haben)	(6 times)
hadt	(hat)	(1 times)
hadte	(hatte)	(1 times)
haeimlich	(heimlich)	(1 times)
hag	(hab)	(1 times)
haht	(hat)	(1 times)
hak	(hat)	(1 times)
hal	(hat)	(1 times)
halder	(halten)	(1 times)
hale	(habe)	(4 times)
halen	(haben)	(1 times)
hall	(hallo)	(1 times)
hallten	(halten)	(3 times)
halltet	(haltet)	(3 times)
halo	(hallo)	(2 times)
hals	(als)	(1 times)
halsban	(Halsband)	(1 times)
haltan	(halten)	(1 times)
halteStäle	(Haltestelle)	(1 times)
haltehelle	(Haltestelle)	(1 times)
haltestele	(Haltestelle)	(1 times)
haltsband	(Halsband)	(1 times)
halzBand	(Halsband)	(1 times)
halzKete	(Halskette)	(1 times)
halzband	(Halsband)	(2 times)
halzbant	(Halsband)	(1 times)
hankam	(ankam)	(1 times)
hap	(hab)	(5 times)
hapen	(haben)	(1 times)
har	(hat)	(1 times)
harbe	(habe)	(2 times)
harre	(Haare)	(1 times)
has	(hast)	(1 times)
hasst	(hast)	(4 times)
hastich	(hastig)	(1 times)
hate	(hatte)	(4 times)
haten	(hatten)	(1 times)
hatt	(hat)	(48 times)
hatter	(hatte)	(1 times)
haubtsach	(Hauptsache)	(1 times)
hauch	(auch)	(1 times)
haus	(haust)	(1 times)
hausabeit	(Hausarbeit)	(1 times)
hauserest	(Hausarrest)	(1 times)
hausnumer	(Hausnummer)	(1 times)
haustur	(Haustür)	(1 times)
hebe	(habe)	(1 times)
hecktisch	(hektisch)	(1 times)
heimlisch	(heimlich)	(1 times)
heiputzutage	(heutzutage)	(1 times)
heise	(heiße)	(1 times)
heisen	(heißen)	(2 times)
heist	(heißt)	(7 times)
heiß	(heißt)	(1 times)
helt	(hält)	(6 times)
heltet	(haltet)	(1 times)
hemand	(jemand)	(1 times)
hen	(hin)	(1 times)
hengen	(hängen)	(3 times)
hengt	(hängt)	(65 times)
hengte	(hängte)	(4 times)
henterher	(hinterher)	(1 times)
hepy	(happy)	(1 times)
heras	(heraus)	(1 times)
herau	(heraus)	(2 times)
herauß	(heraus)	(1 times)
herfor	(hervor)	(5 times)
herlich	(herrlich)	(1 times)
herlichen	(herrlichen)	(2 times)
herr	(her)	(1 times)
herraus	(heraus)	(15 times)
herrein	(herein)	(1 times)
herrunder	(herunter)	(1 times)
heurt	(hört)	(1 times)
hholo	(hallo)	(1 times)
hicht	(nicht)	(1 times)
hie	(hier)	(1 times)
hiehterhier	(hinterher)	(1 times)
hield	(hielt)	(1 times)
hielft	(hilft)	(1 times)
hiengesest	(hingesetzt)	(1 times)
hiensezen	(hinsetzen)	(1 times)
hienter	(hinter)	(3 times)
hienterher	(hinterher)	(7 times)
hienunter	(hinunter)	(1 times)
hies	(hieß)	(2 times)
higeset	(hingesetzt)	(1 times)
hihr	(hier)	(1 times)
hihrher	(hierher)	(1 times)
hillt	(hielt)	(1 times)
hilt	(hielt)	(1 times)
hinder	(hinter)	(3 times)
hiner	(hinter)	(1 times)
hingesest	(hingesetzt)	(1 times)
hingesezt	(hingesetzt)	(1 times)
hingfalen	(hingefallen)	(1 times)
hingfallen	(hingefallen)	(1 times)
hinggefallen	(hingefallen)	(1 times)
hinn	(hin)	(2 times)
hinnterher	(hinterher)	(1 times)
hinsezen	(hinsetzen)	(3 times)
hinta	(hinter)	(2 times)
hintaHer	(hinterher)	(1 times)
hintaher	(hinterher)	(1 times)
hinte	(hinter)	(4 times)
hinteher	(hinterher)	(4 times)
hinterbeinwe	(Hinterbeine)	(1 times)
hinterheher	(hinterher)	(1 times)
hinterhir	(hinterher)	(1 times)
hintern	(hinter)	(1 times)
hir	(Hier)	(2 times)
hir	(hier)	(19 times)
hiter	(hinter)	(4 times)
hiterher	(hinterher)	(3 times)
hitfe	(Hilfe)	(1 times)
hiß	(hieß)	(1 times)
hleih	(bleib)	(1 times)
hlten	(halten)	(1 times)
hnger	(Hunger)	(1 times)
hofe	(hoffe)	(1 times)
hofentLich	(hoffentlich)	(1 times)
hofentlich	(Hoffentlich)	(1 times)
hofentlich	(hoffentlich)	(1 times)
hoffentliel	(hoffentlich)	(1 times)
hoffnug	(Hoffnung)	(1 times)
hofnung	(Hoffnung)	(4 times)
hoh	(hoch)	(2 times)
hohle	(hole)	(1 times)
hohlt	(holt)	(1 times)
hollen	(holen)	(1 times)
hollt	(holt)	(1 times)
hond	(Hand)	(1 times)
honzentriert	(konzentriert)	(1 times)
hor	(hör)	(1 times)
horen	(hören)	(1 times)
horer	(Hörer)	(1 times)
hort	(hört)	(1 times)
horte	(hörte)	(2 times)
hosee	(Hose)	(1 times)
hot	(hat)	(1 times)
house	(Hause)	(1 times)
ht	(hat)	(2 times)
hta	(hat)	(2 times)
htte	(hatte)	(1 times)
hu	(zu)	(1 times)
hud	(Hund)	(1 times)
hunde-	(Hunde)	(1 times)
hundefuter	(Hundefutter)	(3 times)
hungel	(Hunger)	(1 times)
hungrieg	(hungrig)	(1 times)
hunrig	(hungrig)	(6 times)
hunt	(Hund)	(5 times)
huse	(Hause)	(2 times)
hut	(hat)	(1 times)
hählt	(hält)	(1 times)
hällt	(hält)	(2 times)
hänckte	(hängte)	(1 times)
hänkt	(hängt)	(6 times)
hät	(hat)	(1 times)
häte	(hätte)	(4 times)
hätte	(hatte)	(1 times)
höcher	(höher)	(1 times)
höen	(hören)	(1 times)
höhr	(Hör)	(1 times)
höhrte	(hörte)	(1 times)
hörd	(hört)	(1 times)
hörn	(hören)	(1 times)
hübpft	(hüpft)	(1 times)
i	(in)	(1 times)
ic	(ich)	(1 times)
ich	(sich)	(2 times)
icht	(ich)	(1 times)
idde	(Idee)	(3 times)
ide	(Idee)	(10 times)
idis	(die)	(1 times)
ieh	(ich)	(1 times)
iehre	(ihre)	(1 times)
iem	(ihm)	(1 times)
iemm	(ihm)	(1 times)
ier	(ihr)	(1 times)
iere	(ihre)	(1 times)
ieren	(ihren)	(4 times)
iergentwas	(irgendwas)	(1 times)
iest	(ist)	(1 times)
iher	(ihr)	(2 times)
iher	(ihre)	(1 times)
ihm	(im)	(6 times)
ihmer	(immer)	(1 times)
ihn	(in)	(9 times)
ihrgendwo	(irgendwo)	(1 times)
ihrgentwann	(irgendwann)	(1 times)
ihrgentwas	(irgendwas)	(1 times)
ihrgentwo	(irgendwo)	(1 times)
ihrm	(ihrem)	(1 times)
ihrn	(ihren)	(1 times)
ihs	(ins)	(1 times)
iht	(ihm)	(1 times)
iich	(ich)	(1 times)
im	(ihm)	(25 times)
im	(um)	(1 times)
im-	(im)	(1 times)
imer	(immer)	(39 times)
imer-	(immer)	(1 times)
imern	(immer)	(1 times)
imm	(im)	(2 times)
imma	(immer)	(1 times)
in	(ihn)	(117 times)
in-	(in)	(1 times)
ind	(in)	(3 times)
inden	(indem)	(1 times)
indere	(andere)	(1 times)
ine	(in)	(1 times)
inen	(ihnen)	(3 times)
inenStahd	(Innenstadt)	(1 times)
inn	(ihn)	(1 times)
inn	(in)	(1 times)
innen	(ihnen)	(1 times)
ino	(ins)	(1 times)
interHer	(hinterher)	(1 times)
interesant	(interessant)	(2 times)
intrisert	(interessiert)	(1 times)
inz	(ins)	(3 times)
inzwichen	(inzwischen)	(1 times)
ir	(ihr)	(1 times)
ire	(ihre)	(16 times)
irem	(ihrem)	(7 times)
iren	(ihren)	(18 times)
irer	(ihrer)	(5 times)
irgendtwo	(irgendwo)	(1 times)
irgendwan	(irgendwann)	(1 times)
irgentwan	(irgendwann)	(1 times)
irgentwas	(irgendwas)	(3 times)
irgentwi	(irgendwie)	(1 times)
irgentwie	(irgendwie)	(1 times)
irgentwohin	(irgendwohin)	(2 times)
irhe	(ihre)	(2 times)
irhen	(ihren)	(3 times)
is	(es)	(2 times)
is	(ist)	(8 times)
isch	(ich)	(2 times)
isch	(sich)	(1 times)
isd	(ist)	(2 times)
ish	(ich)	(2 times)
isst	(ist)	(4 times)
ißst	(isst)	(1 times)
j	(ja)	(1 times)
jagd	(jagt)	(2 times)
jake	(Jacke)	(10 times)
jakt	(jagt)	(1 times)
jedz	(jetzt)	(1 times)
jemaand	(jemand)	(1 times)
jemad	(jemand)	(3 times)
jemal	(jemals)	(1 times)
jemamd	(jemand)	(1 times)
jeman	(jemand)	(2 times)
jemana	(jemand)	(1 times)
jemang	(jemand)	(1 times)
jemannd	(jemand)	(2 times)
jemant	(jemand)	(10 times)
jemat	(jemand)	(2 times)
jemmand	(jemand)	(3 times)
jetz	(jetzt)	(15 times)
jezt	(jetzt)	(9 times)
jmant	(jemand)	(1 times)
juges	(junges)	(1 times)
juhnge	(Junge)	(1 times)
k.no	(Kino)	(1 times)
kabiene	(Kabine)	(1 times)
kabunt	(kaputt)	(1 times)
kaeiner	(keiner)	(1 times)
kafen	(kaufen)	(2 times)
kahm	(kam)	(1 times)
kahmen	(kamen)	(2 times)
kahn	(kann)	(2 times)
kainer	(keiner)	(1 times)
kamm	(kam)	(43 times)
kammen	(kamen)	(1 times)
kan	(kann)	(20 times)
kanm	(kann)	(1 times)
kanst	(Kannst)	(1 times)
kanst	(kannst)	(13 times)
kante	(kannte)	(3 times)
kapf	(Kopf)	(1 times)
kapirt	(kapiert)	(1 times)
kapot	(kaputt)	(1 times)
kappunt	(kaputt)	(1 times)
kapput	(kaputt)	(6 times)
kappute	(kaputte)	(4 times)
kapputt	(kaputt)	(1 times)
kapputte	(kaputte)	(1 times)
kapum	(kaputt)	(1 times)
kapurt	(kaputt)	(1 times)
kaput	(kaputt)	(79 times)
kapute	(kaputte)	(13 times)
kaputen	(kaputten)	(3 times)
kaputes	(kaputtes)	(1 times)
karm	(kam)	(4 times)
karn	(kann)	(1 times)
kartag	(Karton)	(1 times)
kartog	(Karton)	(2 times)
kartong	(Karton)	(8 times)
katog	(Karton)	(1 times)
katon	(Karton)	(2 times)
katong	(Karton)	(29 times)
katonk	(Karton)	(3 times)
katorn	(Karton)	(1 times)
keckse	(Kekse)	(7 times)
kefloken	(geflogen)	(1 times)
kefunden	(gefunden)	(2 times)
keg	(leg)	(1 times)
keine	(kleine)	(1 times)
keines	(kleines)	(1 times)
keinner	(keiner)	(1 times)
keksse	(Kekse)	(1 times)
kenen	(kennen)	(1 times)
kenn	(kann)	(1 times)
kete	(Kette)	(3 times)
kiendern	(Kindern)	(1 times)
kieste	(Kiste)	(2 times)
kilingelt	(klingelt)	(1 times)
kingelt	(klingelt)	(1 times)
kinglte	(klingelte)	(1 times)
kipte	(kippte)	(1 times)
kisde	(Kiste)	(6 times)
kla	(klar)	(3 times)
klapen	(klappen)	(2 times)
klapfte	(klopfte)	(1 times)
klapt	(klappt)	(1 times)
klapte	(klappte)	(1 times)
klassenzimer	(Klassenzimmer)	(1 times)
kleich	(gleich)	(1 times)
kleinigkei	(Kleinigkeit)	(1 times)
klengelt	(klingelt)	(2 times)
kleppt	(klebt)	(1 times)
kletert	(klettert)	(4 times)
kliegelt	(klingelt)	(1 times)
klienelt	(klingelt)	(1 times)
kliengeln	(klingeln)	(1 times)
kliengelt	(klingelt)	(4 times)
kligeld	(klingelt)	(1 times)
kligelt	(klingelt)	(8 times)
kliget	(klingelt)	(2 times)
klinelt	(klingelt)	(1 times)
klingehlt	(klingelt)	(1 times)
klingeld	(klingelt)	(6 times)
klingell	(klingelt)	(1 times)
klinget	(klingelt)	(1 times)
klinngeln	(Klingeln)	(1 times)
klngelt	(klingelt)	(1 times)
kluklich	(glücklich)	(1 times)
klärren	(klären)	(1 times)
kmochen	(Knochen)	(1 times)
knal	(Knall)	(2 times)
knalt	(knallt)	(2 times)
knalte	(knallte)	(12 times)
knochenn	(Knochen)	(1 times)
knochn	(Knochen)	(1 times)
knohen	(Knochen)	(2 times)
kom	(komm)	(6 times)
komd	(kommt)	(1 times)
kome	(komme)	(2 times)
komen	(kommen)	(10 times)
kommaen	(kommen)	(1 times)
kommem	(kommen)	(1 times)
kommmt	(kommt)	(1 times)
komomt	(kommt)	(1 times)
komst	(kommst)	(2 times)
komt	(kommt)	(40 times)
konhte	(konnte)	(1 times)
konmen	(kommen)	(1 times)
konnt	(konnte)	(1 times)
konnter	(konnte)	(1 times)
konntrole	(Kontrolle)	(1 times)
konntte	(konnte)	(1 times)
konsentrirt	(konzentriert)	(1 times)
konte	(konnte)	(17 times)
konten	(konnten)	(4 times)
kontte	(konnte)	(1 times)
konzantrien	(konzentrieren)	(1 times)
konzendriert	(konzentriert)	(1 times)
konzentriet	(konzentriert)	(1 times)
konzentrirt	(konzentriert)	(1 times)
konzentrit	(konzentriert)	(1 times)
kopft	(klopft)	(1 times)
koput	(kaputt)	(1 times)
kpput	(kaputt)	(1 times)
krabeld	(krabbelt)	(1 times)
krabelt	(krabbelt)	(2 times)
kralt	(krallt)	(2 times)
kralte	(krallte)	(1 times)
krazt	(kratzt)	(1 times)
krazte	(kratzte)	(1 times)
kreftig	(kräftig)	(1 times)
kreftigen	(kräftigen)	(1 times)
kreuzun	(Kreuzung)	(1 times)
krichen	(kriechen)	(1 times)
krieckt	(kriegt)	(1 times)
kriescht	(kriecht)	(1 times)
krig	(krieg)	(2 times)
krigen	(kriegen)	(6 times)
krigst	(kriegst)	(2 times)
krikst	(kriegst)	(1 times)
kumm	(Komm)	(1 times)
kurs	(kurz)	(1 times)
kurser	(kurzer)	(1 times)
kurstesten	(kürzesten)	(1 times)
kurtz	(kurz)	(1 times)
kurwe	(Kurve)	(2 times)
könen	(können)	(7 times)
könte	(könnte)	(10 times)
köntest	(könntest)	(2 times)
kürz	(kurz)	(1 times)
lachde	(lachte)	(2 times)
ladet	(landet)	(1 times)
lag	(lang)	(1 times)
lagsam	(langsam)	(1 times)
lagsm	(langsam)	(1 times)
lahte	(lachte)	(1 times)
langsamm	(langsam)	(1 times)
langsum	(langsam)	(1 times)
langweilich	(langweilig)	(2 times)
lansm	(langsam)	(1 times)
lanweilig	(langweilig)	(2 times)
lasen	(lassen)	(4 times)
laud	(laut)	(1 times)
laute	(lauter)	(1 times)
laüft	(läuft)	(2 times)
lecheln	(lächeln)	(1 times)
lechelt	(lächelt)	(4 times)
lechelte	(lächelte)	(5 times)
lechilt	(lächelt)	(1 times)
leckts	(leckt)	(1 times)
ledsdensd	(letztens)	(1 times)
legde	(legte)	(1 times)
leget	(legt)	(1 times)
leherin	(Lehrerin)	(2 times)
lehrehren	(Lehrerin)	(1 times)
lehrein	(Lehrerin)	(1 times)
lehren	(leeren)	(2 times)
leim	(beim)	(1 times)
leis	(leise)	(1 times)
leit	(leid)	(3 times)
leken	(lecken)	(1 times)
lekommen	(bekommen)	(1 times)
lekte	(leckte)	(1 times)
lemeben	(leben)	(1 times)
lengst	(längst)	(1 times)
lepten	(lebten)	(1 times)
lerehrin	(Lehrerin)	(1 times)
lererin	(Lehrerin)	(8 times)
lererrin	(Lehrerin)	(1 times)
lerm	(Lärm)	(1 times)
letzen	(letzten)	(2 times)
leuft	(läuft)	(10 times)
leut	(laut)	(1 times)
lezden	(letzten)	(1 times)
lezte	(letzte)	(1 times)
lezten	(letzten)	(2 times)
lib	(lieb)	(1 times)
liben	(lieben)	(1 times)
liber	(lieber)	(1 times)
liblingsessen	(Lieblingsessen)	(1 times)
liblingstessen	(Lieblingsessen)	(1 times)
lieckt	(liegt)	(1 times)
liencks	(links)	(1 times)
lienks	(links)	(2 times)
lies	(ließ)	(6 times)
lif	(lief)	(3 times)
ligen	(liegen)	(4 times)
ligt	(liegt)	(12 times)
limlich	(nämlich)	(1 times)
locht	(lacht)	(1 times)
lohs	(los)	(1 times)
loker	(locker)	(2 times)
lokerer	(lockerer)	(1 times)
lolte	(sollte)	(1 times)
losGerisen	(losgerissen)	(1 times)
losgelasen	(losgelassen)	(2 times)
losgelaße	(losgelassen)	(1 times)
losgellasen	(losgelassen)	(1 times)
loslasen	(loslassen)	(2 times)
loss	(los)	(5 times)
luft	(läuft)	(1 times)
lug	(lag)	(1 times)
lächeld	(lächelnd)	(1 times)
lächerte	(lächelte)	(1 times)
läst	(lässt)	(15 times)
läste	(löste)	(1 times)
läuf	(läuft)	(1 times)
löchelt	(lächelt)	(1 times)
löscher	(Löcher)	(1 times)
lüst	(löst)	(1 times)
mach	(nach)	(1 times)
machnn	(machen)	(1 times)
machs	(machst)	(2 times)
mahen	(machen)	(2 times)
mahl	(mal)	(1 times)
maht	(macht)	(4 times)
mall	(mal)	(14 times)
mam	(man)	(1 times)
mann	(man)	(10 times)
manter	(Mantel)	(1 times)
marg	(mag)	(1 times)
mauar	(Mauer)	(1 times)
medchen	(Mädchen)	(1 times)
meer	(mehr)	(6 times)
meher	(mehr)	(1 times)
mehere	(mehrere)	(1 times)
meinzt	(meinst)	(1 times)
mekert	(meckert)	(1 times)
mer	(mehr)	(60 times)
mer	(mir)	(1 times)
merck	(merkt)	(1 times)
mercken	(merken)	(1 times)
merckt	(merkt)	(3 times)
mergt-	(merkt)	(1 times)
merhgt	(merkt)	(1 times)
merr	(mehr)	(3 times)
meue	(neue)	(1 times)
mher	(mehr)	(1 times)
mi	(mir)	(1 times)
micht	(nicht)	(1 times)
mid	(mit)	(2 times)
miehr	(mir)	(1 times)
mier	(mir)	(4 times)
miet	(mit)	(3 times)
minte	(meinte)	(1 times)
minut	(Minute)	(2 times)
mir	(mit)	(1 times)
mis	(mit)	(1 times)
mist	(mit)	(1 times)
mit	(mir)	(1 times)
mitanander	(miteinander)	(1 times)
mitarbeita	(Mitarbeiter)	(1 times)
mitbeckommen	(mitbekommen)	(1 times)
mitbring	(mitbringen)	(1 times)
mite	(mit)	(1 times)
miten	(mitten)	(3 times)
miternander	(miteinander)	(1 times)
mitgbracht	(mitgebracht)	(1 times)
mitgebacht	(mitgebracht)	(1 times)
mitgebrht	(mitgebracht)	(1 times)
mitgemomem	(mitgenommen)	(1 times)
mitgemomen	(mitgenommen)	(1 times)
mitgenomen	(mitgenommen)	(2 times)
mitkennome	(mitgenommen)	(1 times)
mitleit	(Mitleid)	(1 times)
mitnehm	(mitnehmen)	(1 times)
mitnemen	(mitnehmen)	(8 times)
mitt	(mit)	(5 times)
moch	(noch)	(1 times)
momen	(Moment)	(1 times)
momend	(Moment)	(2 times)
momeng	(Moment)	(1 times)
morgenz	(morgens)	(1 times)
mouer	(Mauer)	(1 times)
mugirig	(neugierig)	(1 times)
mull	(Müll)	(1 times)
munt	(Mund)	(1 times)
murmelete	(murmelte)	(1 times)
mus	(muss)	(6 times)
mussen	(müssen)	(4 times)
musst	(muss)	(1 times)
must	(musst)	(1 times)
muste	(musste)	(18 times)
musten	(mussten)	(3 times)
mäcchen	(Mädchen)	(1 times)
mächte	(möchte)	(1 times)
mädschen	(Mädchen)	(1 times)
mähr	(mehr)	(1 times)
möcht	(möchte)	(1 times)
möcklich	(möglich)	(2 times)
mögliech	(möglich)	(1 times)
möglige	(mögliche)	(1 times)
möhte	(möchte)	(1 times)
mörkt	(merkt)	(1 times)
möschde	(möchte)	(1 times)
möschte	(möchte)	(1 times)
möste	(möchte)	(1 times)
müchte	(möchte)	(1 times)
mül	(Müll)	(1 times)
müleimer	(Mülleimer)	(1 times)
mülleimmer	(Mülleimer)	(1 times)
müsen	(müssen)	(4 times)
müstest	(müsstest)	(1 times)
nab	(hab)	(1 times)
nac	(nach)	(6 times)
nach	(noch)	(4 times)
nachbeer	(Nachbar)	(1 times)
nachber	(Nachbar)	(4 times)
nachberin	(Nachbarin)	(4 times)
nachicht	(Nachricht)	(1 times)
nachmitag	(Nachmittag)	(2 times)
nachrich	(Nachricht)	(1 times)
nachste	(nächste)	(1 times)
nachsten	(nächsten)	(3 times)
nachtbar	(Nachbar)	(1 times)
nachte	(machte)	(1 times)
nadürlich	(natürlich)	(1 times)
nah	(nach)	(4 times)
nahn	(nahm)	(1 times)
nahs	(nass)	(1 times)
nalütlich	(natürlich)	(1 times)
namlich	(nämlich)	(2 times)
nardürlich	(natürlich)	(2 times)
narmens	(namens)	(1 times)
nartulich	(natürlich)	(1 times)
narturlich	(natürlich)	(2 times)
nartürlich	(Natürlich)	(1 times)
nartürlisch	(natürlich)	(1 times)
nat	(hat)	(1 times)
natrüchlich	(natürlich)	(2 times)
natulich	(natürlich)	(2 times)
naturlich	(natürlich)	(1 times)
natörlich	(natürlich)	(1 times)
natülich	(natürlich)	(1 times)
natürlig	(natürlich)	(1 times)
ncht	(nicht)	(3 times)
nd	(und)	(1 times)
nebeneinnander	(nebeneinander)	(1 times)
nechme	(nehme)	(1 times)
nechmen	(nehmen)	(1 times)
nechsten	(nächsten)	(1 times)
necksten	(nächsten)	(1 times)
neh	(ne)	(1 times)
nehbehn	(neben)	(1 times)
nehben	(neben)	(3 times)
nehmlich	(nämlich)	(1 times)
nehmmen	(nehmen)	(1 times)
nei	(nein)	(2 times)
neil	(weil)	(1 times)
neinen	(einen)	(1 times)
neißt	(heißt)	(1 times)
nem	(dem)	(1 times)
neme	(nehme)	(1 times)
nemen	(nehmen)	(4 times)
nemlich	(nämlich)	(8 times)
nemt	(nehmt)	(2 times)
net	(nett)	(1 times)
neueschkeiten	(Neuigkeiten)	(1 times)
neugirig	(neugierig)	(3 times)
nevös	(nervös)	(1 times)
niccht	(nicht)	(1 times)
nich	(Nicht)	(1 times)
nich	(nicht)	(80 times)
nichd	(nicht)	(2 times)
nichnd	(nicht)	(1 times)
nichs	(nichts)	(1 times)
nicht	(nichts)	(1 times)
nicht-	(nicht)	(1 times)
nichtt	(nicht)	(1 times)
nichtz	(nichts)	(1 times)
nict	(nicht)	(1 times)
niecht	(nicht)	(3 times)
niehmant	(niemand)	(1 times)
nieht	(nicht)	(2 times)
nieman	(niemand)	(2 times)
niemant	(niemand)	(1 times)
niemmd	(nimmt)	(1 times)
niemt	(nimmt)	(2 times)
nien	(nein)	(1 times)
nigs	(nix)	(1 times)
nihmernd	(niemand)	(1 times)
nihmt	(nimmt)	(1 times)
nihn	(in)	(1 times)
niht	(nicht)	(1 times)
niks	(nix)	(2 times)
nim	(nimm)	(1 times)
nimand	(niemand)	(3 times)
nimant	(niemand)	(2 times)
nimlich	(nämlich)	(1 times)
nimmant	(niemand)	(1 times)
nimst	(nimmst)	(2 times)
nimt	(nimmt)	(27 times)
nischt	(nicht)	(1 times)
niss	(nass)	(1 times)
noch	(nach)	(3 times)
nochmall	(nochmal)	(4 times)
nocht	(noch)	(1 times)
noh	(noch)	(4 times)
nonoch	(noch)	(1 times)
nooh	(noch)	(1 times)
nr	(er)	(1 times)
nu	(nur)	(1 times)
nuch	(nach)	(1 times)
nuhr	(nur)	(1 times)
numens	(namens)	(1 times)
numer	(Nummer)	(5 times)
nund	(und)	(1 times)
nurkemzwo	(nirgendwo)	(1 times)
nutiren	(notieren)	(1 times)
nächmlich	(nämlich)	(1 times)
nächten	(nächsten)	(1 times)
nägsten	(nächsten)	(2 times)
nähmisch	(nämlich)	(1 times)
nähmlich	(nämlich)	(3 times)
nänlich	(nämlich)	(1 times)
nästes	(nächstes)	(1 times)
nätürlich	(natürlich)	(2 times)
nürgens	(nirgends)	(2 times)
nüzte	(nützte)	(1 times)
obt	(ob)	(1 times)
obwoll	(obwohl)	(1 times)
od	(ob)	(1 times)
odwoll	(obwohl)	(1 times)
ofen	(offen)	(3 times)
ohb	(ob)	(1 times)
ohn	(ohne)	(1 times)
om	(um)	(1 times)
omamen	(umarmen)	(1 times)
omb	(ob)	(1 times)
one	(ohne)	(5 times)
op	(ob)	(5 times)
orang	(orange)	(1 times)
ortnun	(Ordnung)	(1 times)
ortnung	(Ordnung)	(1 times)
ou	(du)	(1 times)
oub	(ob)	(1 times)
paeinlich	(peinlich)	(1 times)
pahr	(paar)	(1 times)
pakst	(packst)	(1 times)
pakt	(packt)	(1 times)
panig	(Panik)	(1 times)
par	(paar)	(12 times)
parr	(paar)	(3 times)
parsirt	(passiert)	(2 times)
pas	(pass)	(1 times)
pasieren	(passieren)	(3 times)
pasiert	(passiert)	(20 times)
pasiren	(passieren)	(2 times)
pasirt	(passiert)	(16 times)
pasirte	(passierte)	(6 times)
passiren	(passieren)	(3 times)
passirt	(passiert)	(10 times)
persiert	(passiert)	(1 times)
persirt	(passiert)	(1 times)
piestole	(Pistole)	(1 times)
pipsen	(Piepsen)	(1 times)
pisiert	(passiert)	(1 times)
plackarte	(Plakate)	(1 times)
plackate	(Plakate)	(6 times)
plagate	(Plakate)	(1 times)
plakarse	(Plakate)	(1 times)
plakarte	(Plakate)	(6 times)
plakatte	(Plakate)	(1 times)
plarkarte	(Plakate)	(1 times)
plaz	(Platz)	(1 times)
plazte	(platzte)	(2 times)
plesiert	(passiert)	(1 times)
plitchnass	(klitschnass)	(1 times)
plotzlich	(plötzlich)	(7 times)
plumste	(plumpste)	(2 times)
plölzlich	(plötzlich)	(1 times)
plöstlich	(Plötzlich)	(2 times)
plötslich	(plötzlich)	(2 times)
plötzlch	(plötzlich)	(1 times)
plötzli	(plötzlich)	(1 times)
plötzlin	(plötzlich)	(1 times)
plötztlich	(plötzlich)	(1 times)
plözlich	(plötzlich)	(15 times)
plözliech	(plötzlich)	(1 times)
plöztlich	(plötzlich)	(1 times)
poblem	(Problem)	(1 times)
poo	(Po)	(1 times)
puatschen	(quatschen)	(1 times)
puzen	(putzen)	(1 times)
pötzlich	(plötzlich)	(1 times)
raante	(rannte)	(1 times)
ragte	(sagte)	(2 times)
rain	(rein)	(1 times)
rakette	(Rakete)	(1 times)
ralsgegommen	(rausgekommen)	(1 times)
rann	(ran)	(1 times)
rante	(rannte)	(36 times)
ranten	(rannten)	(2 times)
rar	(war)	(1 times)
rau	(raus)	(1 times)
rauft	(ruft)	(1 times)
rause	(raus)	(1 times)
rausgegommen	(rausgekommen)	(1 times)
rausgehkommen	(rausgekommen)	(1 times)
rausgehold	(rausgeholt)	(1 times)
rauss	(raus)	(2 times)
rauß	(raus)	(10 times)
raws	(raus)	(1 times)
reberieren	(reparieren)	(1 times)
rechen	(rechnen)	(1 times)
rechtseitisch	(rechtzeitig)	(1 times)
rechz	(rechts)	(2 times)
redem	(jedem)	(1 times)
rehnen	(rennen)	(4 times)
rehnt	(rennt)	(1 times)
reihn	(rein)	(1 times)
reinn	(rein)	(1 times)
reist	(reißt)	(7 times)
reizt	(reißt)	(1 times)
renen	(rennen)	(5 times)
rennd	(rennt)	(9 times)
rennet	(rennt)	(1 times)
rent	(rennt)	(37 times)
reten	(retten)	(2 times)
reumen	(räumen)	(2 times)
reumt	(räumt)	(2 times)
rhr	(ihr)	(1 times)
richdich	(richtig)	(2 times)
richdig	(richtig)	(1 times)
richen	(riechen)	(1 times)
richtich	(richtig)	(3 times)
rif	(rief)	(6 times)
ris	(riss)	(1 times)
rischtung	(Richtung)	(1 times)
risig	(riesig)	(2 times)
risige	(riesige)	(1 times)
risigen	(riesigen)	(1 times)
roch	(noch)	(1 times)
ronter	(runter)	(1 times)
rs	(es)	(1 times)
ruat	(ruft)	(1 times)
ruber	(rüber)	(1 times)
rucksag	(Rucksack)	(3 times)
rucksak	(Rucksack)	(9 times)
rucksok	(Rucksack)	(1 times)
rufd	(ruft)	(1 times)
rufft	(ruft)	(1 times)
ruhm	(rum)	(1 times)
ruig	(ruhig)	(1 times)
ruihg	(ruhig)	(1 times)
ruksack	(Rucksack)	(2 times)
ruksak	(Rucksack)	(5 times)
rumlauen	(rumlaufen)	(1 times)
runder	(runter)	(15 times)
rundergefalen	(runtergefallen)	(2 times)
rundergefallen	(runtergefallen)	(1 times)
rundter	(runter)	(2 times)
runeta	(runter)	(1 times)
runta	(runter)	(5 times)
runtatu	(runter)	(1 times)
runterfale	(runterfallen)	(1 times)
runterfalen	(runterfallen)	(1 times)
runtergefalen	(runtergefallen)	(8 times)
runtergeffallen	(runtergefallen)	(1 times)
ruscht	(rutscht)	(2 times)
ruschten	(rutschten)	(1 times)
ruter	(runter)	(2 times)
rutergefalen	(runtergefallen)	(1 times)
ruut	(ruft)	(1 times)
rweil	(weil)	(1 times)
s	(es)	(5 times)
sPasieren	(spazieren)	(1 times)
sa	(sah)	(2 times)
saKt	(sagt)	(1 times)
saagte	(sagte)	(1 times)
sach	(sah)	(1 times)
sachen	(suchen)	(1 times)
sachgt	(sagt)	(1 times)
saein	(sein)	(1 times)
sagd	(sagt)	(2 times)
sagde	(sagte)	(3 times)
saglt	(sagt)	(1 times)
sagrt	(sagt)	(1 times)
sags	(sagst)	(1 times)
sahgte	(sagte)	(2 times)
sahr	(sah)	(8 times)
sahr	(sehr)	(1 times)
saht	(sagt)	(2 times)
sahte	(sagte)	(4 times)
sahß	(saß)	(1 times)
sakd	(sagt)	(1 times)
sakt	(sagt)	(9 times)
sakte	(sagte)	(4 times)
sameln	(sammeln)	(1 times)
sann	(dann)	(1 times)
sar	(sah)	(1 times)
sargt	(sagt)	(3 times)
sargte	(sagte)	(1 times)
sarß	(saß)	(1 times)
sas	(saß)	(2 times)
sasen	(saßen)	(2 times)
sate	(sagte)	(1 times)
sauba	(sauber)	(2 times)
saubsauger	(Staubsauger)	(1 times)
saukt	(saugt)	(3 times)
schPringt	(springt)	(1 times)
schaf=en	(schaffen)	(1 times)
schafen	(schaffen)	(1 times)
schaft	(schafft)	(5 times)
schafte	(schaffte)	(7 times)
schan	(schon)	(1 times)
schaniere	(Scharniere)	(1 times)
schbazieren	(spazieren)	(1 times)
schdaupsauger	(Staubsauger)	(2 times)
schell	(schnell)	(2 times)
schemt	(schämt)	(2 times)
schemte	(schämte)	(1 times)
schicherheit	(Sicherheit)	(1 times)
schif	(schief)	(3 times)
schik	(schick)	(2 times)
schiken	(schicken)	(1 times)
schin	(schön)	(1 times)
schlaft	(schläft)	(2 times)
schlap	(schlapp)	(1 times)
schlecht	(schleicht)	(1 times)
schleft	(schläft)	(3 times)
schlegt	(schlägt)	(1 times)
schleichst	(schleicht)	(1 times)
schleunigs	(schleunigst)	(1 times)
schliest	(schließt)	(1 times)
schlim	(schlimm)	(1 times)
schlislich	(schließlich)	(1 times)
schllechter	(schlechter)	(1 times)
schluk	(Schluck)	(1 times)
schlus	(Schluss)	(4 times)
schläfschen	(Schläfchen)	(1 times)
schmeisen	(schmeißen)	(3 times)
schmeist	(schmeißt)	(4 times)
schmeizt	(schmeißt)	(1 times)
schmekt	(schmeckt)	(1 times)
schmertz	(Schmerz)	(2 times)
schmiltzt	(schmilzt)	(1 times)
schmutsig	(schmutzig)	(1 times)
schmuzig	(schmutzig)	(2 times)
schmütz	(Schmutz)	(1 times)
schnapt	(schnappt)	(1 times)
schneel	(schnell)	(1 times)
schnel	(schnell)	(55 times)
schneler	(schneller)	(4 times)
schnelle	(schnell)	(1 times)
schnnel	(schnell)	(2 times)
schnäl	(schnell)	(1 times)
schockiet	(schockiert)	(1 times)
schockirt	(schockiert)	(1 times)
schohn	(schon)	(2 times)
schokolarde	(Schokolade)	(1 times)
schonen	(schönen)	(3 times)
schoner	(schöner)	(1 times)
schonkte	(schenkte)	(1 times)
schonn	(schon)	(6 times)
schonnen	(schönen)	(1 times)
schop	(schob)	(1 times)
schpaziern	(spazieren)	(1 times)
schpaziren	(spazieren)	(1 times)
schpielen	(spielen)	(2 times)
schprang	(sprang)	(1 times)
schprechen	(sprechen)	(1 times)
schpringt	(springt)	(2 times)
schpäter	(später)	(2 times)
schrebtisch	(Schreibtisch)	(1 times)
schreglich	(schrecklich)	(1 times)
schreid	(schreit)	(1 times)
schreiltisch	(Schreibtisch)	(1 times)
schrek	(Schreck)	(1 times)
schreklich	(schrecklich)	(1 times)
schrekliches	(Schreckliches)	(1 times)
schretblisch	(Schreibtisch)	(1 times)
schri	(schrie)	(2 times)
schrib	(schrieb)	(1 times)
schriete	(Schritte)	(2 times)
schräkliche	(schreckliche)	(1 times)
schspaziren	(spazieren)	(1 times)
schtaubsauger	(Staubsauger)	(1 times)
schtaunte	(staunte)	(1 times)
schtreich	(Streich)	(1 times)
schuchtern	(schüchtern)	(1 times)
schuere	(schwere)	(1 times)
schuhle	(Schule)	(1 times)
schuldich	(schuldig)	(1 times)
schulle	(Schule)	(2 times)
schun	(schon)	(2 times)
schutelt	(schüttelt)	(1 times)
schwerigkeiten	(Schwierigkeiten)	(1 times)
schänken	(schenken)	(1 times)
schöhn	(schön)	(1 times)
schön	(schon)	(1 times)
schönnen	(schönen)	(4 times)
schönner	(schöner)	(1 times)
schüsel	(Schüssel)	(1 times)
schüss	(tschüss)	(1 times)
schütellt	(schüttelt)	(1 times)
se	(sie)	(4 times)
sechr	(sehr)	(1 times)
see	(sei)	(1 times)
seh	(sehr)	(2 times)
seha	(sehr)	(1 times)
seher	(sehen)	(1 times)
seher	(sehr)	(6 times)
sehn	(sehen)	(4 times)
sehn	(sehr)	(1 times)
sehnsüschtig	(sehnsüchtig)	(1 times)
sehtzt	(setzt)	(2 times)
sehzt	(setzt)	(1 times)
sei	(sie)	(3 times)
seid	(seit)	(3 times)
seien	(sein)	(3 times)
seien	(seinen)	(1 times)
seigt	(zeigt)	(4 times)
seigte	(zeigte)	(1 times)
selps	(selbst)	(1 times)
selpst	(selbst)	(1 times)
ser	(sehr)	(12 times)
serh	(sehr)	(2 times)
sesel	(Sessel)	(1 times)
setz	(setzt)	(1 times)
sezen	(setzen)	(1 times)
sezht	(setzt)	(1 times)
sezte	(setzte)	(1 times)
seßte	(setzte)	(1 times)
sgt	(sagt)	(4 times)
sgte	(sagte)	(2 times)
sha	(sah)	(2 times)
sher	(sehr)	(2 times)
shie	(sie)	(1 times)
shperigt	(springt)	(1 times)
shönne	(schöne)	(1 times)
si	(Sie)	(1 times)
si	(sie)	(24 times)
sic	(sich)	(1 times)
sichs	(sich)	(1 times)
sicn	(sich)	(1 times)
siech	(sich)	(22 times)
sied	(sind)	(1 times)
siee	(sie)	(1 times)
sieh	(sich)	(4 times)
sieh	(sie)	(3 times)
sieh	(sieht)	(1 times)
sieich	(sich)	(1 times)
sien	(sein)	(2 times)
siend	(sind)	(10 times)
siene	(seine)	(1 times)
siesch	(sich)	(4 times)
siet	(sieht)	(18 times)
sietzt	(sitzt)	(1 times)
siezt	(sitzt)	(1 times)
sih	(sich)	(2 times)
sih	(sie)	(1 times)
sihe	(sie)	(1 times)
sihet	(sieht)	(1 times)
siht	(sieht)	(15 times)
silzt	(sitzt)	(1 times)
sin	(sie)	(2 times)
sin	(sind)	(5 times)
sinde	(sind)	(1 times)
sindt	(sind)	(1 times)
sinnd	(sind)	(1 times)
sint	(sind)	(16 times)
sisch	(sich)	(3 times)
sist	(ist)	(1 times)
sit	(ist)	(1 times)
sit	(sie)	(1 times)
sitsen	(sitzen)	(3 times)
sitz	(sitzt)	(1 times)
sitzenen	(sitzenden)	(1 times)
sizt	(sitzt)	(6 times)
sizten	(sitzen)	(1 times)
sofahrt	(sofort)	(1 times)
sofart	(sofort)	(1 times)
sofiel	(soviel)	(1 times)
sofohrt	(sofort)	(1 times)
sofor	(sofort)	(2 times)
soford	(sofort)	(1 times)
sofot	(sofort)	(2 times)
sofurd	(sofort)	(1 times)
soga	(sogar)	(5 times)
soger	(sogar)	(9 times)
sogren	(Sorgen)	(1 times)
sogt	(sagt)	(1 times)
soh	(so)	(3 times)
sohfort	(sofort)	(1 times)
sohl	(soll)	(1 times)
sohon	(schon)	(1 times)
sol	(so)	(1 times)
sol	(soll)	(2 times)
solen	(Sollen)	(1 times)
solen	(sollen)	(2 times)
solln	(sollen)	(1 times)
solte	(sollte)	(6 times)
soltest	(solltest)	(1 times)
sonder	(sondern)	(3 times)
soniegen	(sonnigen)	(1 times)
sonigen	(sonnigen)	(7 times)
soningen	(sonnigen)	(1 times)
sonniegen	(sonnigen)	(1 times)
sons	(sonst)	(2 times)
sont	(sonst)	(1 times)
sonzt	(sonst)	(2 times)
sopp	(Stopp)	(1 times)
sovort	(sofort)	(3 times)
sowiso	(sowieso)	(1 times)
sowort	(sofort)	(1 times)
spanende	(spannende)	(1 times)
spanung	(Spannung)	(1 times)
sparang	(sprang)	(1 times)
spartziergang	(Spaziergang)	(1 times)
sparzieren	(spazieren)	(2 times)
sparzihen	(spazieren)	(1 times)
sparziren	(spazieren)	(1 times)
spaschwein	(Sparschwein)	(1 times)
spasieren	(spazieren)	(2 times)
spat	(spät)	(1 times)
spater	(später)	(1 times)
spatzieren	(spazieren)	(12 times)
spatziren	(spazieren)	(8 times)
spatzirn	(spazieren)	(3 times)
spaziern	(spazieren)	(1 times)
spaziren	(spazieren)	(9 times)
spazirgang	(Spaziergang)	(4 times)
spazirn	(spazieren)	(1 times)
speder	(später)	(1 times)
speler	(später)	(1 times)
spet	(spät)	(1 times)
speter	(später)	(11 times)
spiellen	(spielen)	(1 times)
spieln	(spielen)	(1 times)
spilen	(spielen)	(23 times)
spingt	(springt)	(2 times)
spiß	(Spieß)	(1 times)
sprag	(sprang)	(1 times)
sprarchlos	(sprachlos)	(1 times)
sprengen	(springen)	(1 times)
sprengt	(springt)	(1 times)
sprichen	(sprechen)	(1 times)
spriegt	(springt)	(1 times)
spriengt	(springt)	(1 times)
sprienk	(spring)	(1 times)
sprigt	(springt)	(2 times)
springd	(springt)	(1 times)
sprinkt	(springt)	(9 times)
sprint	(springt)	(4 times)
spruch	(sprach)	(1 times)
sprun	(Sprung)	(1 times)
späte	(später)	(1 times)
sqrint	(springt)	(1 times)
srater	(später)	(1 times)
stacken	(starken)	(1 times)
stad	(Stadt)	(3 times)
staine	(Steine)	(1 times)
stan	(stand)	(1 times)
standt	(stand)	(2 times)
stannd	(stand)	(1 times)
stant	(stand)	(4 times)
starcken	(starken)	(1 times)
staub-sauger	(Staubsauger)	(1 times)
staubsauga	(Staubsauger)	(1 times)
staubsauker	(Staubsauger)	(1 times)
staup	(Staub)	(1 times)
staupsauber	(Staubsauger)	(1 times)
staupsauger	(Staubsauger)	(2 times)
stausauger	(Staubsauger)	(5 times)
stautsaugter	(Staubsauger)	(1 times)
stazion	(Station)	(1 times)
staziren	(spazieren)	(1 times)
ste	(steh)	(1 times)
stehd	(steht)	(1 times)
stehet	(steht)	(1 times)
stehlt	(stellt)	(2 times)
stehn	(Stehen)	(1 times)
stehn	(stehen)	(7 times)
steigehn	(steigen)	(1 times)
steikt	(steigt)	(3 times)
steken	(stecken)	(1 times)
stelen	(stellen)	(1 times)
stellte-	(stellte)	(1 times)
stelte	(stellte)	(1 times)
steraße	(Straße)	(1 times)
stet	(steht)	(13 times)
steth	(steht)	(1 times)
sthecht	(steht)	(1 times)
stieft	(Stift)	(2 times)
stiek	(stieg)	(2 times)
stiel	(still)	(1 times)
stif	(Stift)	(1 times)
stig	(stieg)	(9 times)
stil	(still)	(3 times)
stime	(Stimme)	(1 times)
stimmme	(Stimme)	(1 times)
stimt	(stimmt)	(2 times)
stoch	(Stock)	(1 times)
stolbert	(stolpert)	(1 times)
stolpart	(stolpert)	(1 times)
stopen	(Stoppen)	(1 times)
stopen	(stoppen)	(2 times)
stopfte	(stoppte)	(1 times)
stopt	(stoppt)	(1 times)
stopte	(stoppte)	(2 times)
stpingt	(springt)	(1 times)
straf	(straff)	(1 times)
stralte	(strahlte)	(1 times)
strarken	(starken)	(1 times)
strase	(Straße)	(1 times)
strekt	(streckt)	(1 times)
sträckt	(streckt)	(1 times)
stuck	(Stück)	(1 times)
stul	(Stuhl)	(1 times)
stummt	(stimmt)	(1 times)
stund	(Stunde)	(1 times)
sturtzt	(stürzt)	(1 times)
sturzt	(stürzt)	(2 times)
stzen	(setzen)	(1 times)
stzät	(setzt)	(1 times)
stüft	(Stift)	(2 times)
stük	(Stück)	(2 times)
stürst	(stürzt)	(2 times)
stürste	(stürzte)	(1 times)
stürtze	(stürzte)	(1 times)
stürtzt	(stürzt)	(1 times)
su	(zu)	(5 times)
such	(sich)	(1 times)
suchd	(sucht)	(1 times)
suhcht	(sucht)	(2 times)
suhrt	(sucht)	(1 times)
suht	(sucht)	(2 times)
sum	(zum)	(3 times)
susamen	(zusammen)	(2 times)
swar	(zwar)	(1 times)
sätzt	(setzt)	(1 times)
säzt	(setzt)	(1 times)
söner	(schöner)	(1 times)
sücht	(sucht)	(1 times)
süss	(süß)	(1 times)
taasche	(Tasche)	(1 times)
tad	(tat)	(1 times)
tagges	(Tages)	(1 times)
tags	(Tages)	(1 times)
tah	(tat)	(1 times)
taht	(tat)	(1 times)
tail	(Teil)	(1 times)
tarurig	(traurig)	(1 times)
tas	(das)	(1 times)
tasächlich	(tatsächlich)	(1 times)
tatsechlich	(tatsächlich)	(1 times)
tatzechlich	(tatsächlich)	(1 times)
taurig	(traurig)	(1 times)
tedyber	(Teddybär)	(1 times)
tedybär	(Teddybär)	(2 times)
tehma	(Thema)	(1 times)
teisch	(Teich)	(2 times)
telefohn	(Telefon)	(1 times)
telefonirt	(telefoniert)	(2 times)
telefonnumer	(Telefonnummer)	(2 times)
telefonnuner	(Telefonnummer)	(1 times)
telefonumer	(Telefonnummer)	(1 times)
telfon	(Telefon)	(1 times)
tellefon	(Telefon)	(1 times)
telofon	(Telefon)	(3 times)
telofonNumer	(Telefonnummer)	(1 times)
tenefon	(Telefon)	(1 times)
tepich	(Teppich)	(2 times)
ter	(der)	(1 times)
tiaurich	(traurig)	(1 times)
toch	(doch)	(1 times)
toroPfen	(Tropfen)	(1 times)
tozdem	(trotzdem)	(1 times)
tragich	(tragisch)	(1 times)
trairig	(traurig)	(1 times)
trapfen	(Tropfen)	(1 times)
trarich	(traurig)	(1 times)
trarig	(traurig)	(1 times)
trauchrig	(traurig)	(1 times)
trauf	(drauf)	(1 times)
traugi	(traurig)	(1 times)
trauig	(traurig)	(3 times)
trauraig	(traurig)	(1 times)
traureg	(traurig)	(3 times)
traurg	(traurig)	(2 times)
trauri	(traurig)	(1 times)
traurich	(traurig)	(52 times)
traurieg	(traurig)	(3 times)
traurik	(traurig)	(4 times)
traurisch	(traurig)	(2 times)
trefen	(treffen)	(12 times)
trepe	(Treppe)	(1 times)
trepen	(Treppen)	(1 times)
trieft	(trifft)	(1 times)
trift	(trifft)	(6 times)
troft	(tropft)	(1 times)
trostet	(tröstet)	(1 times)
trotdem	(trotzdem)	(1 times)
trotztem	(trotzdem)	(1 times)
trotztim	(trotzdem)	(1 times)
trourig	(traurig)	(1 times)
trozdem	(trotzdem)	(3 times)
trraurig	(traurig)	(1 times)
truarig	(traurig)	(1 times)
trunter	(drunter)	(1 times)
tröpfschen	(Tröpfchen)	(1 times)
trüsten	(trösten)	(1 times)
tu	(du)	(6 times)
tuen	(tun)	(3 times)
tuhe	(tue)	(1 times)
tuhn	(tun)	(1 times)
tuht	(tut)	(1 times)
tunde	(Stunde)	(1 times)
turn	(Turm)	(1 times)
tüar	(Tür)	(1 times)
tüe	(Tür)	(1 times)
türm	(Turm)	(1 times)
tüt	(tut)	(2 times)
tütte	(Tüte)	(1 times)
u	(du)	(3 times)
ubar	(über)	(1 times)
ubehaubt	(überhaupt)	(1 times)
uber	(über)	(11 times)
uberal	(überall)	(1 times)
uberall	(überall)	(2 times)
ubergluglich	(überglücklich)	(1 times)
uberglücklich	(überglücklich)	(1 times)
uberrall	(überall)	(1 times)
uberschrift	(Überschrift)	(1 times)
ubrig	(übrig)	(2 times)
ud	(und)	(2 times)
udn	(und)	(1 times)
ueggelaufen	(weggelaufen)	(1 times)
umSons	(umsonst)	(1 times)
umahrmte	(umarmte)	(1 times)
umamd	(umarmt)	(2 times)
umamten	(umarmten)	(3 times)
umarmde	(umarmte)	(2 times)
umarmdend	(umarmten)	(1 times)
umarmmte	(umarmte)	(1 times)
umarmtete	(umarmte)	(1 times)
umarte	(umarmte)	(2 times)
umbedieng	(unbedingt)	(1 times)
umbedinkt	(unbedingt)	(2 times)
umd	(und)	(1 times)
umgefalen	(umgefallen)	(2 times)
umgeffalen	(umgefallen)	(1 times)
umglük	(Unglück)	(1 times)
umramen	(umarmen)	(1 times)
umsontst	(umsonst)	(1 times)
umsonzt	(umsonst)	(1 times)
umtamt	(umarmt)	(1 times)
un	(an)	(1 times)
un	(und)	(25 times)
una	(und)	(3 times)
unarmte	(umarmte)	(1 times)
unauffelig	(unauffällig)	(1 times)
und-	(und)	(1 times)
undd	(und)	(1 times)
unde	(und)	(2 times)
unden	(unten)	(1 times)
under	(unter)	(15 times)
unds	(und)	(1 times)
undter	(unter)	(2 times)
unfal	(Unfall)	(2 times)
unfähr	(unfair)	(1 times)
ungeduldi	(ungeduldig)	(1 times)
ungefalen	(umgefallen)	(1 times)
unger	(Hunger)	(1 times)
unglauplich	(unglaublich)	(1 times)
unl	(und)	(1 times)
unn	(und)	(1 times)
unnter	(unter)	(1 times)
unrufer	(Anrufer)	(1 times)
uns	(und)	(1 times)
unsehre	(unsere)	(1 times)
unt	(und)	(23 times)
untahalten	(unterhalten)	(1 times)
untaricht	(Unterricht)	(1 times)
untawegs	(unterwegs)	(1 times)
unte	(unter)	(1 times)
unterhalten-	(unterhalten)	(1 times)
unterich	(Unterricht)	(1 times)
untericht	(Unterricht)	(9 times)
unternemen	(unternehmen)	(1 times)
unterrich	(Unterricht)	(1 times)
unterwecks	(unterwegs)	(1 times)
unterweks	(unterwegs)	(2 times)
unvall	(Unfall)	(1 times)
unvorsigtig	(unvorsichtig)	(1 times)
unz	(uns)	(1 times)
uon	(von)	(1 times)
urd	(wird)	(1 times)
urgentwas	(irgendwas)	(1 times)
uter	(unter)	(2 times)
uuf	(auf)	(2 times)
uund	(und)	(2 times)
vLog	(flog)	(1 times)
vackelig	(wackelig)	(1 times)
vallen	(fallen)	(1 times)
valoren	(verloren)	(1 times)
vam	(vom)	(1 times)
van	(von)	(3 times)
vangen	(fangen)	(1 times)
vargas	(vergaß)	(1 times)
vartet	(wartet)	(1 times)
varwiert	(verwirrt)	(1 times)
vast	(fast)	(3 times)
veertig	(fertig)	(1 times)
veg	(weg)	(2 times)
vegesen	(vergessen)	(1 times)
vegessen	(vergessen)	(1 times)
vegessene	(vergessene)	(1 times)
vehrschwundende	(verschwundene)	(1 times)
veil	(weil)	(3 times)
velore	(verloren)	(1 times)
veloren	(verloren)	(1 times)
venster	(Fenster)	(2 times)
vensterbank	(Fensterbank)	(1 times)
venzter	(Fenster)	(2 times)
vepassen	(verpassen)	(1 times)
ver	(Der)	(1 times)
ver-	(wer)	(1 times)
ver-sucht	(versucht)	(1 times)
veraten	(verraten)	(1 times)
verblüft	(verblüfft)	(1 times)
verchwunden	(verschwunden)	(2 times)
verchwwnden	(verschwunden)	(1 times)
verdamten	(verdammten)	(1 times)
vergas	(vergaß)	(6 times)
vergehsen	(vergessen)	(1 times)
vergesen	(vergessen)	(45 times)
vergesene	(vergessene)	(1 times)
vergesesn	(vergessen)	(1 times)
vergessem	(vergessen)	(1 times)
vergiest	(vergisst)	(2 times)
vergist	(vergisst)	(2 times)
vergoken	(verloren)	(1 times)
vergsen	(vergessen)	(2 times)
vergssen	(vergessen)	(1 times)
vergäsen	(vergessen)	(2 times)
verhgesen	(vergessen)	(1 times)
verhroren	(verloren)	(1 times)
verlarene	(verlorene)	(1 times)
verlayren	(verloren)	(1 times)
verlohr	(verlor)	(1 times)
verlohren	(verloren)	(3 times)
verlorn	(verloren)	(2 times)
vermiest	(vermisst)	(1 times)
vermist	(vermisst)	(39 times)
vermiste	(vermisste)	(3 times)
vermisten	(vermissten)	(1 times)
vermistt	(vermisst)	(1 times)
verpast	(verpasst)	(1 times)
verrgesen	(vergessen)	(1 times)
verrschwunden	(verschwunden)	(2 times)
verschtanden	(verstanden)	(2 times)
verschteckt	(versteckt)	(3 times)
verschunden	(verschwunden)	(1 times)
verschwant	(verschwand)	(1 times)
verschwonden	(verschwunden)	(1 times)
verschwuden	(verschwunden)	(1 times)
verschwundden	(verschwunden)	(1 times)
verschwunde	(verschwunden)	(1 times)
verschwundende	(verschwundene)	(1 times)
verschwundete	(verschwundene)	(1 times)
versehn	(Versehen)	(1 times)
verstakt	(versteckt)	(1 times)
verstecks	(versteckst)	(1 times)
verstekckt	(versteckt)	(1 times)
verstekt	(versteckt)	(2 times)
verstet	(versteht)	(1 times)
versucrt	(versucht)	(1 times)
vertief	(vertieft)	(1 times)
vertig	(fertig)	(13 times)
verwandert	(verwundert)	(1 times)
verwiert	(verwirrt)	(1 times)
verwird	(verwirrt)	(1 times)
verwirt	(verwirrt)	(2 times)
verwolgen	(verfolgen)	(1 times)
verwört	(verwirrt)	(1 times)
verzfeifelt	(verzweifelt)	(1 times)
verzweifeld	(verzweifelt)	(2 times)
verzweiflet	(verzweifelt)	(1 times)
verzweihfelt	(verzweifelt)	(1 times)
verzweilfelt	(verzweifelt)	(1 times)
verückt	(verrückt)	(4 times)
verückte	(verrückte)	(3 times)
verükte	(verrückte)	(1 times)
vest	(fest)	(4 times)
vestheld	(festhält)	(1 times)
vieder	(wieder)	(1 times)
viel	(fiel)	(8 times)
vielecht	(vielleicht)	(1 times)
vieleicht	(vielleicht)	(5 times)
vieleiht	(vielleicht)	(1 times)
vielen	(fielen)	(1 times)
viellen	(Vielen)	(1 times)
viellen	(vielen)	(1 times)
viellich	(vielleicht)	(1 times)
vieln	(vielen)	(1 times)
vienden	(finden)	(1 times)
vileicht	(Vielleicht)	(1 times)
vileicht	(vielleicht)	(3 times)
ving	(fing)	(2 times)
vinger	(Finger)	(1 times)
virtelstunde	(Viertelstunde)	(1 times)
vleißig	(fleißig)	(1 times)
vliegt	(fliegt)	(1 times)
vligt	(fliegt)	(1 times)
vo	(wo)	(1 times)
vobei	(vorbei)	(1 times)
vohrher	(vorher)	(1 times)
vol	(voll)	(2 times)
volkomen	(vollkommen)	(1 times)
voller-	(voller)	(1 times)
vollt	(wollt)	(1 times)
voloren	(verloren)	(1 times)
vonn	(von)	(1 times)
voreher	(vorher)	(1 times)
vorloren	(verloren)	(1 times)
vorsichtg	(vorsichtig)	(1 times)
vot	(vor)	(1 times)
vragt	(fragt)	(1 times)
vreude	(Freude)	(3 times)
vrmisst	(vermisst)	(1 times)
vroh	(froh)	(1 times)
vrölich	(fröhlich)	(1 times)
vun	(von)	(1 times)
vält	(fällt)	(1 times)
vängt	(fängt)	(1 times)
völig	(völlig)	(1 times)
vür	(für)	(4 times)
wa	(war)	(18 times)
wa	(was)	(1 times)
wa-	(war)	(1 times)
wachtete	(wartete)	(1 times)
wackeld	(wackelt)	(1 times)
wackliger	(wackeliger)	(1 times)
waeiter	(weiter)	(1 times)
waen	(waren)	(1 times)
wagun	(Wagen)	(1 times)
wah	(war)	(1 times)
wahr	(war)	(38 times)
wahren	(waren)	(6 times)
wahrf	(warf)	(1 times)
wahrm	(warm)	(1 times)
wahrtet	(wartet)	(1 times)
wail	(weil)	(1 times)
waint	(weint)	(1 times)
wakelig	(wackelig)	(1 times)
wakeln	(wackeln)	(2 times)
wakelt	(wackelt)	(2 times)
wallen	(fallen)	(1 times)
wallte	(wollte)	(1 times)
wan	(wann)	(1 times)
war	(wir)	(1 times)
wardet	(wartet)	(4 times)
ware	(war)	(1 times)
waret	(wartet)	(1 times)
wargehsen	(vergessen)	(1 times)
warheen	(waren)	(1 times)
warn	(waren)	(2 times)
warren	(waren)	(2 times)
wars	(was)	(1 times)
warted	(wartet)	(3 times)
wartede	(wartete)	(1 times)
warun	(Warum)	(1 times)
warun	(warum)	(1 times)
warwm	(warum)	(1 times)
waser	(Wasser)	(10 times)
waserienierg	(fasziniert)	(1 times)
wass	(was)	(4 times)
wast	(fast)	(3 times)
wate	(warte)	(1 times)
watet	(wartet)	(16 times)
watete	(wartete)	(4 times)
watte	(warte)	(1 times)
we	(weh)	(2 times)
wecKgelaufen	(weggelaufen)	(1 times)
weckesenn	(wechseln)	(1 times)
weckgelaufen	(weggelaufen)	(6 times)
weckseln	(wechseln)	(1 times)
weder	(wieder)	(1 times)
wegelaufen	(weggelaufen)	(4 times)
wegfligt	(wegfliegt)	(1 times)
weggehlaufen	(weggelaufen)	(1 times)
weggelt	(weggeht)	(1 times)
weggerant	(weggerannt)	(1 times)
wegt	(weg)	(1 times)
wegwerven	(wegwerfen)	(1 times)
wehg	(weg)	(1 times)
wehgehgetan	(wehgetan)	(1 times)
wehgen	(wegen)	(1 times)
weider	(weiter)	(1 times)
weider	(wieder)	(1 times)
weiel	(weil)	(5 times)
weihl	(weil)	(1 times)
weihnen	(weinen)	(1 times)
weiler	(weiter)	(2 times)
weill	(weil)	(9 times)
weind	(weint)	(27 times)
weinde	(weinte)	(1 times)
weinenrn	(weinen)	(1 times)
weinent	(weinend)	(9 times)
weinete	(weinte)	(1 times)
weinnen	(weinen)	(1 times)
weinnent	(weinend)	(1 times)
weints	(weinst)	(1 times)
weis	(weiß)	(16 times)
weist	(weißt)	(9 times)
weit	(weil)	(1 times)
weite	(weinte)	(1 times)
weite	(weiter)	(3 times)
weiten	(weitem)	(1 times)
wek	(weg)	(16 times)
wekgelauf	(weggelaufen)	(1 times)
wekgelaufen	(weggelaufen)	(7 times)
wekgerant	(weggerannt)	(2 times)
weklauen	(weglaufen)	(1 times)
wekselt	(wechselt)	(2 times)
wel	(weil)	(2 times)
wemand	(jemand)	(2 times)
wen	(wenn)	(23 times)
wenigsten	(wenigstens)	(1 times)
wenm	(wenn)	(1 times)
wenster	(Fenster)	(1 times)
wente	(weinte)	(1 times)
weot	(weit)	(1 times)
wer	(war)	(2 times)
werd	(wert)	(1 times)
werd	(wird)	(1 times)
were	(wäre)	(6 times)
werend	(während)	(2 times)
wergas	(vergaß)	(1 times)
wergehsen	(vergessen)	(1 times)
wergesen	(vergessen)	(5 times)
wergessen	(vergessen)	(1 times)
werlaufen	(verlaufen)	(1 times)
werlirt	(verliert)	(1 times)
werlor	(verlor)	(1 times)
werr	(wer)	(1 times)
werschwundene	(verschwundene)	(1 times)
wersucht	(versucht)	(1 times)
wertig	(fertig)	(2 times)
wg	(weg)	(1 times)
wider	(wieder)	(160 times)
widergefunden	(wiedergefunden)	(1 times)
widerhaben	(wiederhaben)	(2 times)
widerzusehen	(wiederzusehen)	(2 times)
wieber	(wieder)	(1 times)
wieda	(wieder)	(2 times)
wiede	(wieder)	(1 times)
wiedr	(wieder)	(1 times)
wieer	(wieder)	(1 times)
wiel	(fiel)	(2 times)
wiel	(will)	(13 times)
wielen	(vielen)	(1 times)
wiell	(will)	(1 times)
wiend	(Wind)	(1 times)
wiengte	(winkte)	(1 times)
wier	(wir)	(6 times)
wierd	(wird)	(2 times)
wiesen	(wissen)	(7 times)
wigen	(wegen)	(1 times)
wihr	(wir)	(1 times)
wil	(will)	(17 times)
wilst	(willst)	(1 times)
winde	(finde)	(1 times)
winte	(winkte)	(1 times)
wir	(wie)	(1 times)
wir	(wird)	(1 times)
wircklich	(wirklich)	(1 times)
wirder	(wieder)	(1 times)
wirglich	(wirklich)	(3 times)
wirs	(wirst)	(1 times)
wirt	(wird)	(5 times)
wisen	(wissen)	(8 times)
wishen	(wissen)	(1 times)
wnd	(und)	(5 times)
wngeduldich	(ungeduldig)	(1 times)
woh	(wo)	(3 times)
wohlte	(wollte)	(4 times)
wohnug	(Wohnung)	(1 times)
wol	(wohl)	(3 times)
wolehn	(wollen)	(1 times)
wolen	(wollen)	(8 times)
woll	(wohl)	(6 times)
wolte	(wollte)	(126 times)
won	(von)	(3 times)
wonen	(wohnen)	(1 times)
wonhin	(wohin)	(1 times)
wont	(wohnt)	(1 times)
wonung	(Wohnung)	(1 times)
wonzimmer	(Wohnzimmer)	(1 times)
wor	(vor)	(2 times)
wor	(war)	(1 times)
worbei	(vorbei)	(1 times)
worde	(wurde)	(1 times)
worf	(warf)	(1 times)
worher	(vorher)	(1 times)
wragte	(fragte)	(2 times)
wrtet	(wartet)	(1 times)
wrum	(warum)	(1 times)
wurklich	(wirklich)	(1 times)
wusse	(wusste)	(1 times)
wuste	(wusste)	(28 times)
wusten	(wussten)	(4 times)
wustes	(wusstest)	(1 times)
wustest	(wusstest)	(1 times)
wäg	(weg)	(4 times)
wägwerfen	(wegwerfen)	(1 times)
währe	(wäre)	(1 times)
währst	(wärst)	(1 times)
wänd	(Wand)	(1 times)
wärend	(während)	(2 times)
wörd	(wird)	(1 times)
wükend	(wütend)	(1 times)
wünderschöner	(wunderschöner)	(1 times)
wür	(für)	(2 times)
würd	(wird)	(2 times)
würd	(würde)	(2 times)
würde	(wurde)	(1 times)
würft	(wirft)	(4 times)
würklich	(wirklich)	(1 times)
wüste	(wüsste)	(1 times)
wüsten	(wüssten)	(1 times)
wüten	(wütend)	(1 times)
wütent	(wütend)	(4 times)
ya	(ja)	(4 times)
yar	(gar)	(1 times)
yemand	(jemand)	(3 times)
yemant	(jemand)	(3 times)
yetzt	(jetzt)	(4 times)
zabrochenden	(zerbrochenen)	(1 times)
zaigde	(zeigte)	(1 times)
zar	(zur)	(1 times)
zaulerei	(Zauberei)	(1 times)
zebrochene	(zerbrochene)	(1 times)
zeik	(zeig)	(1 times)
zeikt	(zeigt)	(2 times)
zenster	(Fenster)	(1 times)
zerbochene	(zerbrochene)	(1 times)
zerbrauchene	(zerbrochene)	(1 times)
zerissen	(zerrissen)	(1 times)
zerrießen	(zerrissen)	(1 times)
zerrisen	(zerrissen)	(1 times)
zerte	(zerrte)	(2 times)
zervelt	(zerfällt)	(1 times)
zerzweilfett	(verzweifelt)	(1 times)
zetel	(Zettel)	(7 times)
zeuknis	(Zeugnis)	(1 times)
zich	(sich)	(1 times)
ziet	(zieht)	(13 times)
zihen	(ziehen)	(2 times)
ziht	(zieht)	(8 times)
zimer	(Zimmer)	(1 times)
zimlich	(ziemlich)	(2 times)
zitzt	(sitzt)	(2 times)
zo	(so)	(1 times)
zohg	(zog)	(1 times)
zoll	(soll)	(1 times)
zraf	(traf)	(1 times)
zu-	(zu)	(1 times)
zufort	(sofort)	(1 times)
zufriden	(zufrieden)	(11 times)
zugig	(zügig)	(1 times)
zuh	(zu)	(2 times)
zuh	(zur)	(1 times)
zuhr	(zur)	(1 times)
zukük	(zurück)	(1 times)
zulasen	(zulassen)	(1 times)
zuletz	(zuletzt)	(1 times)
zumm	(zum)	(1 times)
zun	(zum)	(1 times)
zur	(zu)	(2 times)
zurck	(zurück)	(1 times)
zurhause	(Zuhause)	(1 times)
zurrück	(zurück)	(1 times)
zuruck	(zurück)	(4 times)
zuruk	(zurück)	(3 times)
zuröck	(zurück)	(1 times)
zurüg	(zurück)	(3 times)
zurüggekomen	(zurückgekommen)	(1 times)
zurük	(zurück)	(12 times)
zurükgekomin	(zurückgekommen)	(1 times)
zusamen	(zusammen)	(32 times)
zussamen	(zusammen)	(2 times)
zussammen	(zusammen)	(1 times)
zuvriden	(zufrieden)	(1 times)
zw	(zu)	(4 times)
zwichen	(zwischen)	(3 times)
zwm	(zum)	(1 times)
zürck	(zurück)	(2 times)
zürick	(zurück)	(1 times)
züruck	(zurück)	(5 times)
zürück	(zurück)	(5 times)
zürückkommt	(zurückkommt)	(1 times)
Öfnete	(öffnete)	(1 times)
Überaschung	(Überraschung)	(6 times)
Überrachung	(Überraschung)	(1 times)
Überraschchung	(Überraschung)	(1 times)
Überraschund	(Überraschung)	(1 times)
Ürgendwan	(Irgendwann)	(1 times)
ägstra	(extra)	(1 times)
ällterer	(älterer)	(1 times)
änglich	(endlich)	(1 times)
ängslich	(ängstlich)	(1 times)
ängtlich	(ängstlich)	(1 times)
ärgentwo	(irgendwo)	(1 times)
ärgär	(Ärger)	(1 times)
äuch	(euch)	(1 times)
öfnet	(öffnet)	(1 times)
öfnete	(öffnete)	(1 times)
öfnette	(öffnete)	(1 times)
öfnte	(öffnete)	(1 times)
über-	(über)	(1 times)
überacht	(überrascht)	(1 times)
überal	(überall)	(3 times)
überalh	(überall)	(1 times)
überalle	(überall)	(1 times)
überascht	(überrascht)	(2 times)
überaschung	(Überraschung)	(10 times)
überglüglich	(überglücklich)	(1 times)
überglüklich	(überglücklich)	(4 times)
überhollen	(überholen)	(1 times)
überlegb	(überlegt)	(1 times)
überlekt	(überlegt)	(1 times)
überracht	(überrascht)	(2 times)
überral	(überall)	(1 times)
überrall	(überall)	(1 times)
überrast	(überrascht)	(1 times)
überscht	(überrascht)	(1 times)
überzeügt	(überzeugt)	(1 times)
üder	(über)	(3 times)
ülberall	(überall)	(1 times)
üüber	(über)	(1 times)
