-aufgestanden	(aufgestanden)	(1 times)
Aals	(Als)	(1 times)
Aalte	(alte)	(2 times)
Aauf	(Auf)	(3 times)
Aaus	(Aus)	(1 times)
Aause	(Hause)	(1 times)
Abe	(Aber)	(1 times)
Abeit	(Arbeit)	(1 times)
Abgehelt	(abgeholt)	(1 times)
Absich	(Absicht)	(2 times)
Aderese	(Adresse)	(1 times)
Adrese	(Adresse)	(2 times)
Adrresse	(Adresse)	(1 times)
Aein	(ein)	(1 times)
Agerufen	(angerufen)	(1 times)
Ale	(Alle)	(4 times)
Ales	(Alles)	(5 times)
Ales	(alles)	(1 times)
Alls	(Als)	(15 times)
Allte	(alte)	(2 times)
Allz	(Als)	(3 times)
Alr	(Als)	(2 times)
Alz	(Als)	(2 times)
Angekomen	(angekommen)	(1 times)
Anhatten	(anhalten)	(1 times)
Annruff	(Anruf)	(1 times)
Anrruft	(anruft)	(1 times)
Anru=f	(Anruf)	(2 times)
Anruft	(Anruf)	(1 times)
Anruhf	(Anruf)	(1 times)
Anschließen	(Anschließend)	(1 times)
Anschlißend	(Anschließend)	(2 times)
Anstat	(Anstatt)	(1 times)
Antort	(Antwort)	(1 times)
Anuft	(anruft)	(1 times)
Ap	(ab)	(2 times)
Aperat	(Apparat)	(1 times)
Auf-	(Auf)	(1 times)
Aufgehregt	(aufgeregt)	(1 times)
Aufgole	(Aufgabe)	(1 times)
AugenbliK	(Augenblick)	(1 times)
Auss	(Aus)	(1 times)
Auß	(Aus)	(1 times)
Baden	(Boden)	(1 times)
Bahm	(Bahn)	(1 times)
Bark	(Park)	(2 times)
Bas	(Bus)	(1 times)
Bauhen	(bauen)	(1 times)
Bbätter	(Blätter)	(1 times)
Befor	(Bevor)	(1 times)
Beibe	(Beide)	(1 times)
Bekomen	(bekommen)	(2 times)
Beld	(Bild)	(1 times)
Bereis	(bereits)	(1 times)
Besitzarin	(Besitzerin)	(1 times)
Bestimt	(Bestimmt)	(1 times)
Beuen	(bauen)	(1 times)
Beurtel	(Beutel)	(1 times)
Bewekt	(bewegt)	(1 times)
Bielder	(Bilder)	(1 times)
Bilda	(Bilder)	(1 times)
Bilt	(Bild)	(1 times)
Blat	(Blatt)	(8 times)
Bleb	(Bleib)	(1 times)
Blitzt	(Blitz)	(1 times)
Blumenstraus	(Blumenstrauß)	(1 times)
Blutzlich	(Plötzlich)	(1 times)
Blädter	(Blätter)	(1 times)
Bläter	(Blätter)	(2 times)
Blötzlich	(Plötzlich)	(1 times)
Bochtel	(Beutel)	(1 times)
Bonen	(Boden)	(1 times)
Brigen	(bringen)	(1 times)
Buden	(Boden)	(1 times)
Bur	(Bus)	(1 times)
Burgersteik	(Bürgersteig)	(1 times)
Busfarher	(Busfahrer)	(1 times)
Busfuhrer	(Busfahrer)	(1 times)
Bushalltestelle	(Bushaltestelle)	(1 times)
Bushaltestele	(Bushaltestelle)	(1 times)
Buss	(Bus)	(34 times)
Busshaltestelle	(Bushaltestelle)	(1 times)
Buß	(Bus)	(1 times)
Bäutel	(Beutel)	(8 times)
Bötel	(Beutel)	(1 times)
Bötell	(Beutel)	(3 times)
Bütelel	(Beutel)	(1 times)
D	(Da)	(1 times)
Dabai	(Dabei)	(1 times)
Dabhei	(Dabei)	(1 times)
Dach	(Doch)	(1 times)
Dah	(Da)	(1 times)
Damme	(Dame)	(1 times)
Dan	(Dann)	(58 times)
Danachh	(Danach)	(1 times)
Danck	(Dank)	(1 times)
Dancke	(Danke)	(3 times)
Dannach	(Danach)	(8 times)
Dannach	(danach)	(2 times)
Dannnach	(Danach)	(1 times)
Darbei	(Dabei)	(1 times)
Das	(Dass)	(5 times)
Das	(dass)	(5 times)
DasWegen	(Deswegen)	(1 times)
Dasche	(Tasche)	(1 times)
Dass	(Das)	(1 times)
Daswegen	(Deswegen)	(1 times)
Daw	(Da)	(1 times)
Denn	(Dann)	(1 times)
Denn	(den)	(1 times)
Deusch	(Deutsch)	(1 times)
Diregt	(Direkt)	(1 times)
Do	(Da)	(1 times)
Docb	(Doch)	(1 times)
Donach	(Danach)	(1 times)
Donerstag	(Donnerstag)	(1 times)
Drausen	(Draußen)	(2 times)
Drausen	(draußen)	(6 times)
Dreckt	(Dreck)	(1 times)
Dreg	(Dreck)	(1 times)
Drek	(Dreck)	(1 times)
Drof	(drauf)	(1 times)
Drükt	(drückt)	(1 times)
Dun	(Dann)	(1 times)
Dunach	(Danach)	(2 times)
Echsplosohn	(Explosion)	(1 times)
Ecker	(Ecke)	(1 times)
Ecksplusiom	(Explosion)	(1 times)
Eeinen	(Einen)	(1 times)
Eeis	(Eis)	(10 times)
Eende	(Ende)	(1 times)
Eiemal	(Einmal)	(1 times)
Eienes	(Eines)	(1 times)
Einkaufzentrum	(Einkaufszentrum)	(1 times)
Eins	(Eines)	(1 times)
Eisdile	(Eisdiele)	(2 times)
Eistile	(Eisdiele)	(1 times)
Eke	(Ecke)	(2 times)
Elter	(Eltern)	(1 times)
Endliech	(Endlich)	(1 times)
Endschuldigung	(Entschuldigung)	(2 times)
Englich	(Endlich)	(1 times)
Enschuldigung	(Entschuldigung)	(2 times)
Entlich	(Endlich)	(1 times)
Entschuldiegung	(Entschuldigung)	(1 times)
Erger	(Ärger)	(1 times)
Erns	(Ernst)	(1 times)
Ers	(Er)	(1 times)
Erstaund	(erstaunt)	(1 times)
Erstem	(ersten)	(1 times)
Expliosion	(Explosion)	(1 times)
Explodirt	(explodiert)	(1 times)
Eäschrocken	(erschrocken)	(1 times)
Fagsen	(Faxen)	(1 times)
Fahrbe	(Farbe)	(1 times)
Faler	(Voller)	(1 times)
Fals	(Falls)	(1 times)
Famist	(vermisst)	(1 times)
Famiste	(vermisste)	(1 times)
Fedy	(Teddy)	(2 times)
Fehlt	(fällt)	(1 times)
Fehnster	(Fenster)	(3 times)
Fehrnsehen	(Fernsehen)	(1 times)
Fehrstekte	(versteckte)	(1 times)
Feld	(fällt)	(1 times)
Fellt	(fällt)	(1 times)
Felt	(fällt)	(4 times)
Fengt	(fängt)	(2 times)
Fenst	(Fenster)	(2 times)
Fensta	(Fenster)	(1 times)
Fenstbank	(Fensterbank)	(1 times)
Fenste	(Fenster)	(11 times)
Fenstehr	(Fenster)	(2 times)
Fenster-bank	(Fensterbank)	(1 times)
FensterRamen	(Fensterrahmen)	(1 times)
Fensterbant	(Fensterbank)	(1 times)
Fensterbret	(Fensterbrett)	(1 times)
Fensterbund	(Fensterbank)	(1 times)
Fensterhanck	(Fensterbank)	(1 times)
Fensterramen	(Fensterrahmen)	(4 times)
Fenter	(Fenster)	(1 times)
Fenzter	(Fenster)	(3 times)
FenzterBank	(Fensterbank)	(1 times)
Fenzterscheibe	(Fensterscheibe)	(1 times)
Ferabschiedet	(verabschiedet)	(1 times)
Ferkeuver	(Verkäufer)	(1 times)
Ferkäufer	(Verkäufer)	(1 times)
Ferloren	(verloren)	(1 times)
Ferlorene	(Verlorene)	(1 times)
Ferlorene	(verlorene)	(2 times)
Fermist	(vermisst)	(1 times)
Fernster	(Fenster)	(2 times)
Ferstekt	(versteckt)	(1 times)
Fertich	(fertig)	(1 times)
Ferwundert	(Verwundert)	(1 times)
Fesntenerbank	(Fensterbank)	(1 times)
Fesnter	(Fenster)	(1 times)
Fester	(Fenster)	(2 times)
Festerscheibe	(Fensterscheibe)	(1 times)
Feund	(Freund)	(1 times)
Fhenster	(Fenster)	(1 times)
Fielcht	(Vielleicht)	(1 times)
Fil	(fiel)	(1 times)
Fileischt	(Vielleicht)	(1 times)
Flu	(Flur)	(1 times)
Flus	(Fluss)	(1 times)
Fnster	(Fenster)	(4 times)
Fogel	(Vogel)	(6 times)
Fon	(von)	(2 times)
For	(vor)	(3 times)
Forosch	(Frosch)	(1 times)
Forsichtzhalber	(Vorsichtshalber)	(1 times)
Fota	(Foto)	(1 times)
Frauf	(Frau)	(1 times)
Fraund	(Freund)	(1 times)
Fraut	(Frau)	(1 times)
Freind	(Freund)	(1 times)
Freud	(Freund)	(2 times)
Freud	(freut)	(4 times)
Freundinn	(Freundin)	(1 times)
Freunt	(Freund)	(4 times)
Fro	(froh)	(1 times)
Froch	(Frosch)	(17 times)
Frode	(Freude)	(1 times)
Frschundene	(verschwundene)	(1 times)
Frud	(freut)	(1 times)
Frusch	(Frosch)	(1 times)
Frölich	(fröhlich)	(1 times)
Frölig	(fröhlich)	(1 times)
Frü	(Früh)	(1 times)
Früstück	(Frühstück)	(1 times)
Fuau	(Frau)	(1 times)
Fuss	(Fuß)	(1 times)
Fänster	(Fenster)	(3 times)
Fölich	(fröhlich)	(1 times)
Fötchen	(Pfötchen)	(1 times)
Führ	(Für)	(1 times)
Fülehr	(Füller)	(1 times)
Fünten	(fünften)	(1 times)
Fütter	(Futter)	(1 times)
Gasi	(Gassi)	(1 times)
Gassie	(Gassi)	(1 times)
Gassy	(Gassi)	(1 times)
Gechichte	(Geschichte)	(2 times)
Ged	(geht)	(1 times)
Gefonden	(gefunden)	(1 times)
Gegent	(Gegend)	(2 times)
Gehfühl	(Gefühl)	(1 times)
Gehfül	(Gefühl)	(1 times)
Gekomen	(gekommen)	(1 times)
Gen	(gehen)	(1 times)
Geschaft	(Geschafft)	(2 times)
Geschefte	(Geschäfte)	(1 times)
Geschek	(Geschenk)	(1 times)
Geschäftsman	(Geschäftsmann)	(1 times)
Gesichtausdrük	(Gesichtsausdruck)	(1 times)
Gesichtsausdruk	(Gesichtsausdruck)	(1 times)
Ggnse	(ganze)	(1 times)
Gischichte	(Geschichte)	(1 times)
Glasschärben	(Glasscherben)	(1 times)
Glicklich	(glücklich)	(1 times)
Gluck-lich	(glücklich)	(1 times)
Gluckich	(glücklich)	(1 times)
Glucklich	(glücklich)	(3 times)
Gluk	(Glück)	(1 times)
Glöklesch	(glücklich)	(1 times)
Glücklieste	(glücklichste)	(1 times)
Glücklig	(glücklich)	(1 times)
Glücklisch	(glücklich)	(1 times)
Glük	(Glück)	(1 times)
Glüklich	(glücklich)	(6 times)
Glüklich-	(glücklich)	(1 times)
Glüklisch	(glücklich)	(1 times)
Gucgt	(guckt)	(1 times)
Gäfegnis	(Gefängnis)	(1 times)
Habbe	(habe)	(1 times)
Hacken	(Haken)	(1 times)
Halltestelle	(Haltestelle)	(1 times)
Halsbant	(Halsband)	(1 times)
Halskete	(Halskette)	(1 times)
Halteschtelle	(Haltestelle)	(1 times)
Haltestehle	(Haltestelle)	(1 times)
Haltestele	(Haltestelle)	(2 times)
Haltestell	(Haltestelle)	(1 times)
Halz	(Hals)	(1 times)
Halzband	(Halsband)	(1 times)
Hande	(Hände)	(1 times)
Hare	(Haare)	(1 times)
Harren	(Haaren)	(1 times)
Hase	(Hause)	(1 times)
Hate	(hatte)	(3 times)
Hatt	(hat)	(1 times)
Haupt-rollen	(Hauptrollen)	(1 times)
Hausa	(Hause)	(1 times)
Hausabeit	(Hausarbeit)	(1 times)
Hauser	(Häuser)	(1 times)
Hauserest	(Hausarrest)	(1 times)
Hausofgaben	(Hausaufgaben)	(1 times)
Helt	(hält)	(1 times)
Hendler	(Händler)	(1 times)
Hengen	(hängen)	(1 times)
Hengt	(hängt)	(2 times)
Henkt	(hängt)	(3 times)
Her.	(Herr)	(2 times)
Hlfe	(Hilfe)	(1 times)
Hllo	(Hallo)	(1 times)
Hofnwng	(Hoffnung)	(1 times)
Hohrer	(Hörer)	(1 times)
Horben	(Haben)	(1 times)
Hosse	(Hose)	(1 times)
Hundefuder	(Hundefutter)	(1 times)
Hunkrich	(hungrig)	(1 times)
Hunt	(Hund)	(1 times)
Huse	(Hause)	(4 times)
Händ	(Hand)	(1 times)
Höer	(Hörer)	(1 times)
Hör	(höher)	(1 times)
Hörer	(Höre)	(1 times)
Inenstad	(Innenstadt)	(1 times)
Inochen	(Knochen)	(1 times)
Ir	(Er)	(1 times)
Irgentwan	(Irgendwann)	(1 times)
Jacka	(Jacke)	(1 times)
Jake	(Jacke)	(16 times)
Jeber	(jeder)	(1 times)
Jeds	(Jetzt)	(1 times)
Jeds	(jetzt)	(3 times)
Jedz	(Jetzt)	(1 times)
Jedz	(jetzt)	(1 times)
Jemahd	(Jemand)	(1 times)
Jeman	(jemand)	(2 times)
Jemant	(Jemand)	(1 times)
Jest	(Jetzt)	(1 times)
Jetct	(jetzt)	(1 times)
Jetz	(Jetzt)	(4 times)
Jetz	(jetzt)	(3 times)
Jezt	(Jetzt)	(7 times)
Jezt	(jetzt)	(5 times)
Jeztt	(Jetzt)	(1 times)
Jiemand	(jemand)	(1 times)
Jitzt	(jetzt)	(1 times)
Jst	(Jetzt)	(1 times)
Jung	(Junge)	(3 times)
Kabut	(kaputt)	(1 times)
Kadong	(Karton)	(1 times)
Kaffe	(Kaffee)	(1 times)
Kamf	(Kampf)	(2 times)
Kamm	(kam)	(3 times)
Kan	(kann)	(3 times)
Kannte	(Kante)	(1 times)
Kanst	(Kannst)	(4 times)
Kaoton	(Karton)	(1 times)
Kapputte	(kaputte)	(1 times)
Kaput	(kaputt)	(6 times)
Kartog	(Karton)	(2 times)
Kartong	(Karton)	(16 times)
Kartongt	(Karton)	(3 times)
Katog	(Karton)	(1 times)
Katon	(Karton)	(2 times)
Kaufem	(kaufen)	(1 times)
Kauffen	(kaufen)	(1 times)
Keckse	(Kekse)	(1 times)
Kegse	(Kekse)	(6 times)
Keld	(Geld)	(1 times)
Kerpst	(Herbst)	(1 times)
Kete	(Kette)	(3 times)
Kieste	(Kiste)	(2 times)
Kinde	(Kinder)	(1 times)
Kingelt	(klingelt)	(1 times)
Kis=te	(Kiste)	(1 times)
Kist	(Kiste)	(1 times)
Klass	(Klasse)	(2 times)
Klassenkammeraden	(Klassenkameraden)	(1 times)
Klassenlererin	(Klassenlehrerin)	(1 times)
Klassenszimmer	(Klassenzimmer)	(1 times)
Klassenzimer	(Klassenzimmer)	(1 times)
Klepte	(klebte)	(1 times)
Klinelt	(Klingelt)	(1 times)
Klinelt	(klingelt)	(1 times)
Klinelte	(klingelte)	(1 times)
Klinget	(klingelt)	(1 times)
Kmochen	(Knochen)	(1 times)
Kniee	(Knie)	(1 times)
Knoche	(Knochen)	(1 times)
Knochel	(Knochen)	(2 times)
Knoden	(Knoten)	(1 times)
Knuten	(Knoten)	(1 times)
Kome	(komme)	(1 times)
Komen	(kommen)	(2 times)
Komig	(komisch)	(1 times)
Komt	(kommt)	(1 times)
Konten	(konnten)	(1 times)
Konzentrirt	(konzentriert)	(2 times)
Korper	(Körper)	(1 times)
Kpof	(Kopf)	(1 times)
Kralen	(Krallen)	(3 times)
Kralt	(krallt)	(1 times)
Kuhm	(kaum)	(1 times)
Kummpel	(Kumpel)	(1 times)
Küsche	(Küche)	(2 times)
La	(Ja)	(1 times)
Lamsam	(langsam)	(1 times)
Langweiten	(langweilen)	(1 times)
Lansam	(langsam)	(1 times)
Las	(Lass)	(1 times)
Lechelnde	(lächelnde)	(1 times)
Lechelte	(lächelte)	(1 times)
Leckerlie	(Leckerli)	(2 times)
Leherin	(Lehrerin)	(7 times)
Leherrin	(Lehrerin)	(2 times)
Lehraren	(Lehrerin)	(1 times)
Lehrarin	(Lehrerin)	(2 times)
Lehreerin	(Lehrerin)	(1 times)
Lehrehrin	(Lehrerin)	(1 times)
Lehrelien	(Lehrerin)	(1 times)
Lehren	(leeren)	(1 times)
Lehreren	(Lehrerin)	(2 times)
Lehrerien	(Lehrerin)	(2 times)
Lehrerinn	(Lehrerin)	(1 times)
Leiter	(leider)	(1 times)
Lerarin	(Lehrerin)	(3 times)
Leren	(leeren)	(1 times)
Lerer	(Lehrer)	(1 times)
Lereren	(Lehrerin)	(3 times)
Lererin	(Lehrerin)	(10 times)
Lerhrerin	(Lehrerin)	(1 times)
Lerm	(Lärm)	(3 times)
Lerrerin	(Lehrerin)	(1 times)
Lest	(lässt)	(2 times)
Leste	(letzte)	(1 times)
Letsten	(letzten)	(1 times)
Leuft	(läuft)	(1 times)
Leztem	(letztem)	(1 times)
Lezten	(letzten)	(2 times)
Lie	(Sie)	(1 times)
Lieg	(liegt)	(1 times)
Lies	(ließ)	(1 times)
Ligd	(liegt)	(1 times)
Ligt	(liegt)	(1 times)
Lohrarin	(Lehrerin)	(1 times)
Loss	(los)	(1 times)
Läst	(lässt)	(2 times)
Maan	(Mann)	(2 times)
Madchen	(Mädchen)	(2 times)
Magen	(Morgen)	(1 times)
Mahte	(Mathe)	(2 times)
Mamar	(Mama)	(1 times)
Man	(Mann)	(32 times)
Mann	(Man)	(1 times)
Mann	(man)	(1 times)
Mantell	(Mantel)	(2 times)
Matamatig	(Mathematik)	(1 times)
Matematig	(Mathematik)	(2 times)
Matematik	(Mathematik)	(1 times)
Mathmatik	(Mathematik)	(1 times)
Matte	(Mathe)	(1 times)
Maua	(Mauer)	(7 times)
Mauea	(Mauer)	(1 times)
Mauh	(Mauer)	(1 times)
Medel	(Mädel)	(1 times)
Medschen	(Mädchen)	(1 times)
Mid	(mit)	(1 times)
Minwten	(Minuten)	(1 times)
MitargsSchlarf	(Mittagsschlaf)	(1 times)
Mitt	(mit)	(1 times)
Mitwoch	(Mittwoch)	(1 times)
Mißchon	(Mission)	(1 times)
Mogens	(Morgens)	(1 times)
Morges	(Morgens)	(1 times)
Mrgens	(Morgens)	(1 times)
Mundt	(Mund)	(1 times)
Munt	(Mund)	(1 times)
Muter	(Mutter)	(1 times)
Mächen	(Mädchen)	(8 times)
Mädschen	(Mädchen)	(2 times)
Mänchen	(Mädchen)	(2 times)
Mätchen	(Mädchen)	(5 times)
Mäuer	(Mauer)	(2 times)
Möchtes	(Möchtest)	(1 times)
Möleimer	(Mülleimer)	(1 times)
Mühl	(Müll)	(1 times)
Müleimer	(Mülleimer)	(5 times)
Mülleinmer	(Mülleimer)	(1 times)
Mülltone	(Mülltonne)	(7 times)
Mültone	(Mülltonne)	(1 times)
Nachbarien	(Nachbarin)	(1 times)
Nachberin	(Nachbarin)	(6 times)
Nachberinn	(Nachbarin)	(1 times)
Nachberrin	(Nachbarin)	(1 times)
Nachberschafft	(Nachbarschaft)	(1 times)
Nachicht	(Nachricht)	(2 times)
Nachichten	(Nachrichten)	(1 times)
Nachmitag	(Nachmittag)	(4 times)
Nachmiterg	(Nachmittag)	(1 times)
Nachmitttag	(Nachmittag)	(1 times)
Nachtbar	(Nachbar)	(1 times)
Names	(namens)	(1 times)
Nartbarschaft	(Nachbarschaft)	(1 times)
Nartürlich	(natürlich)	(1 times)
Naturlich	(Natürlich)	(3 times)
Nerfige	(nervige)	(1 times)
Nrummer	(Nummer)	(1 times)
Numer	(Nummer)	(9 times)
Nummen	(Namen)	(1 times)
Nästen	(nächsten)	(1 times)
Oke	(Okay)	(1 times)
Okey	(Okay)	(3 times)
Omer	(Oma)	(1 times)
Oper	(Opa)	(2 times)
Pa	(paar)	(1 times)
Pack	(Park)	(1 times)
Paffekt	(perfekt)	(2 times)
Painlich	(peinlich)	(1 times)
Pakatte	(Plakate)	(1 times)
Par	(Paar)	(1 times)
Par	(paar)	(2 times)
Parck	(Park)	(2 times)
Parg	(Park)	(2 times)
Parr	(paar)	(1 times)
Pas	(Pass)	(3 times)
Pasirte	(passierte)	(1 times)
Passiren	(passieren)	(1 times)
Passirte	(passierte)	(1 times)
Peimlich	(peinlich)	(1 times)
Perfeckt	(perfekt)	(1 times)
Pfand	(fand)	(1 times)
Pfuter	(Futter)	(1 times)
PlaKarte	(Plakate)	(2 times)
Plackarte	(Plakate)	(1 times)
Plackate	(Plakate)	(3 times)
Plackaten	(Plakaten)	(1 times)
Plakal	(Plakat)	(1 times)
Plakart	(Plakat)	(1 times)
Plakarte	(Plakate)	(15 times)
Plakartte	(Plakate)	(1 times)
Plakast	(Plakat)	(1 times)
Plakte	(Plakate)	(1 times)
Plareate	(Plakate)	(1 times)
Platzt	(Platz)	(1 times)
Plockate	(Plakate)	(2 times)
Ploslch	(Plötzlich)	(1 times)
Plotzlich	(Plötzlich)	(25 times)
Plozlich	(Plötzlich)	(1 times)
Pluzlich	(Plötzlich)	(1 times)
Plölich	(Plötzlich)	(2 times)
Plölzlich	(Plötzlich)	(3 times)
Plötlich	(Plötzlich)	(2 times)
Plötslirch	(Plötzlich)	(1 times)
Plötzliche	(Plötzlich)	(1 times)
Plötzlig	(Plötzlich)	(2 times)
Plötzlisch	(Plötzlich)	(1 times)
Plöztich	(Plötzlich)	(1 times)
Plöztlich	(Plötzlich)	(4 times)
Poblem	(Problem)	(1 times)
Poliezei	(Polizei)	(1 times)
Pplatz	(Platz)	(1 times)
Prefeckte	(perfekte)	(1 times)
Pöltzlich	(Plötzlich)	(1 times)
Pölzlich	(Plötzlich)	(1 times)
Pötzlich	(Plötzlich)	(1 times)
Pötzlich	(plötzlich)	(2 times)
RUcksag	(Rucksack)	(1 times)
Ragete	(Rakete)	(1 times)
Ransen	(Ranzen)	(4 times)
Ranzten	(Ranzen)	(1 times)
Rehschnet	(rechnet)	(1 times)
Rend	(rennt)	(1 times)
Rent	(rennt)	(2 times)
Reuber	(Räuber)	(1 times)
RuKsaK	(Rucksack)	(1 times)
Ruchsack	(Rucksack)	(2 times)
Ruckcksack	(Rucksack)	(1 times)
Rucksach	(Rucksack)	(1 times)
Rucksacksack	(Rucksack)	(1 times)
Rucksag	(Rucksack)	(7 times)
Rucksagk	(Rucksack)	(3 times)
Rucksak	(Rucksack)	(13 times)
Rucksasck	(Rucksack)	(1 times)
Rucksuck	(Rucksack)	(2 times)
Rucktack	(Rucksack)	(1 times)
Rugsaag	(Rucksack)	(1 times)
Rugsag	(Rucksack)	(3 times)
Ruksack	(Rucksack)	(3 times)
Ruksag	(Rucksack)	(6 times)
Ruksak	(Rucksack)	(4 times)
Ruksck	(Rucksack)	(1 times)
Rukzak	(Rucksack)	(1 times)
Rumt	(räumt)	(1 times)
Rusak	(Rucksack)	(1 times)
Ruzak	(Rucksack)	(1 times)
Räschnenaufgabe	(Rechenaufgabe)	(1 times)
Röken	(Rücken)	(1 times)
SPaßirgang	(Spaziergang)	(1 times)
Sagd	(sagt)	(1 times)
Sammstag	(Samstag)	(2 times)
Samsta	(Samstag)	(1 times)
Schaf	(schaff)	(1 times)
Schautd	(schaut)	(1 times)
Schbigel	(Spiegel)	(1 times)
Schdift	(Stift)	(2 times)
Schlaffzimmer	(Schlafzimmer)	(1 times)
Schlan	(Schlamm)	(1 times)
Schlimste	(schlimmste)	(1 times)
Schlislich	(Schließlich)	(1 times)
Schlus	(Schluss)	(1 times)
Schmeisen	(schmeißen)	(1 times)
Schmuts	(Schmutz)	(1 times)
Schneicht	(schleicht)	(1 times)
Schnel	(Schnell)	(3 times)
Schnel	(schnell)	(2 times)
Schnupert	(schnuppert)	(1 times)
Schok	(Schock)	(2 times)
Schpeter	(Später)	(1 times)
Schpetter	(Später)	(1 times)
Schreiptisch	(Schreibtisch)	(1 times)
Schrit	(Schritt)	(1 times)
Schrite	(Schritte)	(1 times)
Schtaubsaugen	(Staubsauger)	(1 times)
Schtaubsauger	(Staubsauger)	(2 times)
Schtaup	(Staub)	(1 times)
Schtaupsauger	(Staubsauger)	(2 times)
Schtift	(Stift)	(2 times)
Schubsauger	(Staubsauger)	(1 times)
Schuhle	(Schule)	(12 times)
Schuhlhof	(Schulhof)	(1 times)
Schul	(Schule)	(1 times)
Schuler	(Schüler)	(1 times)
Schulgebeude	(Schulgebäude)	(1 times)
Schulle	(Schule)	(4 times)
Schullfeg	(Schulweg)	(1 times)
Schulule	(Schule)	(1 times)
Schwans	(Schwanz)	(1 times)
Schwinmen	(Schwimmen)	(1 times)
Schünen	(schönen)	(1 times)
Schüs	(Tschüs)	(1 times)
Schüsel	(Schüssel)	(1 times)
Seibe	(Scheibe)	(1 times)
Settel	(Zettel)	(1 times)
Si	(Sie)	(1 times)
Siben	(sieben)	(1 times)
Sic	(sich)	(1 times)
Sied	(Sieht)	(1 times)
Sied	(sieht)	(1 times)
Sieds	(Sitz)	(1 times)
Siest	(Siehst)	(1 times)
Sin	(sind)	(1 times)
Sint	(sind)	(2 times)
Snur	(Schnur)	(1 times)
Sol	(soll)	(1 times)
Sonigen	(sonnigen)	(1 times)
Sonniegen	(sonnigen)	(1 times)
Sontag	(Sonntag)	(2 times)
Sontagmorgen	(Sonntagmorgen)	(2 times)
SparzirStok	(Spazierstock)	(1 times)
Sparziren	(spazieren)	(1 times)
Sparzirgang	(Spaziergang)	(1 times)
Spass	(Spaß)	(1 times)
Spater	(Später)	(1 times)
Spatziren	(spazieren)	(2 times)
Spatzirgang	(Spaziergang)	(1 times)
Spazihren	(spazieren)	(1 times)
Spaziren	(spazieren)	(5 times)
Spazirgang	(Spaziergang)	(1 times)
Spelte	(spielte)	(1 times)
Speter	(Später)	(3 times)
Speter	(später)	(1 times)
Spil	(Spiel)	(1 times)
Spilen	(spielen)	(1 times)
Spliter	(Splitter)	(1 times)
Staadt	(Stadt)	(1 times)
Stab	(Staub)	(1 times)
Stad	(Stadt)	(11 times)
Staine	(Steine)	(1 times)
Standt	(stand)	(1 times)
Stat	(Stadt)	(3 times)
Statd	(Stadt)	(6 times)
StauPsauger	(Staubsauger)	(2 times)
Staubsager	(Staubsauger)	(1 times)
Staubsauga	(Staubsauger)	(1 times)
Staubsaugen	(Staubsauger)	(1 times)
Staubsauger-	(Staubsauger)	(1 times)
Staubseuger	(Staubsauger)	(2 times)
Staudsauger	(Staubsauger)	(1 times)
Staugsauger	(Staubsauger)	(1 times)
Staup	(Staub)	(1 times)
Staupsauber	(Staubsauger)	(1 times)
Staupsauga	(Staubsauger)	(1 times)
Staupsauger	(Staubsauger)	(16 times)
Stieft	(Stift)	(6 times)
Stifft	(Stift)	(1 times)
Stime	(Stimme)	(1 times)
Stit	(steht)	(1 times)
Stplitter	(Splitter)	(1 times)
Straffe	(Strafe)	(1 times)
Strase	(Straße)	(2 times)
Strasen	(Straßen)	(1 times)
Strorße	(Straße)	(1 times)
Stubsauger	(Staubsauger)	(1 times)
Stul	(Stuhl)	(1 times)
Stundnte	(Stunde)	(1 times)
Sätzen	(setzen)	(1 times)
Süss	(süß)	(1 times)
T-shert	(T-Shirt)	(1 times)
Tache	(Tasche)	(1 times)
Tarzächlich	(Tatsächlich)	(1 times)
Tasch	(Tasche)	(27 times)
Tatsechlich	(Tatsächlich)	(1 times)
TeddyBear	(Teddybär)	(1 times)
Teddybear	(Teddybär)	(5 times)
Teddyberen	(Teddybären)	(1 times)
Tedi	(Teddy)	(6 times)
Tedibear	(Teddybär)	(1 times)
Tedy	(Teddy)	(13 times)
Tedybär	(Teddybär)	(1 times)
Tedyy	(Teddy)	(5 times)
Tefefonnummer	(Telefonnummer)	(1 times)
Tehlefon	(Telefon)	(1 times)
Tehma	(Thema)	(1 times)
Teisch	(Teich)	(2 times)
Teke	(Theke)	(1 times)
Telefan	(Telefon)	(1 times)
Telefen	(Telefon)	(1 times)
Telefhonnummer	(Telefonnummer)	(1 times)
Telefohn	(Telefon)	(4 times)
Telefohnnummer	(Telefonnummer)	(1 times)
TelefonNumer	(Telefonnummer)	(1 times)
Telefonn	(Telefon)	(1 times)
Telefonnumer	(Telefonnummer)	(11 times)
Telefonnumme	(Telefonnummer)	(1 times)
Telefonselle	(Telefonzelle)	(1 times)
Telefonumer	(Telefonnummer)	(2 times)
Telefphon	(Telefon)	(1 times)
Telefun	(Telefon)	(2 times)
Telepfon	(Telefon)	(1 times)
Telephon	(Telefon)	(4 times)
Telepone	(Telefon)	(1 times)
Televon	(Telefon)	(1 times)
Telfon	(Telefon)	(1 times)
Telfonnummer	(Telefonnummer)	(1 times)
Tellefon	(Telefon)	(2 times)
Tellefonanumer	(Telefonnummer)	(1 times)
Tellefonn	(Telefon)	(1 times)
Tellefonnummer	(Telefonnummer)	(1 times)
Tellevon	(Telefon)	(1 times)
Telofan	(Telefon)	(1 times)
Telofon	(Telefon)	(3 times)
Telofonnume	(Telefonnummer)	(1 times)
Tema	(Thema)	(1 times)
Tenster	(Fenster)	(1 times)
Tensterbank	(Fensterbank)	(1 times)
Tepich	(Teppich)	(2 times)
Tepig	(Teppich)	(1 times)
Tich	(Tisch)	(3 times)
Tiesch	(Tisch)	(1 times)
Tire	(Tiere)	(1 times)
Tod	(tot)	(1 times)
Tolette	(Toilette)	(1 times)
Tor	(Tür)	(1 times)
Trauegen	(traurigen)	(1 times)
Trauich	(traurig)	(1 times)
Traurch	(traurig)	(1 times)
Traurich	(Traurig)	(1 times)
Traurich	(traurig)	(1 times)
Traurik	(traurig)	(1 times)
Trefen	(treffen)	(2 times)
Trenen	(Tränen)	(9 times)
Trotztim	(Trotzdem)	(1 times)
Tuhen	(tun)	(1 times)
Tur	(Tür)	(3 times)
Turmm	(Turm)	(4 times)
Tör	(Tür)	(1 times)
Tüb	(Typ)	(1 times)
Uberaschung	(Überraschung)	(2 times)
Uberrascht	(überrascht)	(1 times)
Uberraschung	(Überraschung)	(3 times)
Uhrplözlich	(urplötzlich)	(1 times)
Umd	(Und)	(1 times)
Un	(Und)	(3 times)
Und-	(Und)	(1 times)
Undd	(Und)	(1 times)
Ungefär	(Ungefähr)	(1 times)
Unt	(Und)	(1 times)
Untericht	(Unterricht)	(8 times)
Unterischt	(Unterricht)	(1 times)
Unterrecht	(Unterricht)	(1 times)
Urgendwie	(irgendwie)	(1 times)
Vadamt	(verdammt)	(1 times)
Vaitah	(weiter)	(1 times)
Var	(war)	(1 times)
Venster	(Fenster)	(1 times)
Verande	(Veranda)	(1 times)
Vermist	(Vermisst)	(2 times)
Vermiste	(vermisste)	(1 times)
Verwurdert	(Verwundert)	(1 times)
Ville	(viele)	(1 times)
Voge	(Vogel)	(1 times)
WIEDE	(WIEDER)	(1 times)
Waind	(weint)	(1 times)
Wande	(Wände)	(1 times)
Wanile	(Vanille)	(1 times)
Want	(Wand)	(1 times)
Wassa	(Wasser)	(2 times)
Wasserfahl	(Wasserfall)	(1 times)
Watete	(wartete)	(1 times)
Weckgehlaufen	(weggelaufen)	(1 times)
Wegg	(weg)	(1 times)
WeiJel	(weil)	(1 times)
Weill	(Weil)	(1 times)
Weill	(weil)	(1 times)
Weind	(weint)	(5 times)
Weinent	(weinend)	(1 times)
Weist	(Weißt)	(2 times)
Wek	(Weg)	(2 times)
Wen	(Wenn)	(4 times)
Wende	(Wände)	(1 times)
Werend	(Während)	(3 times)
Werenddessen	(Währenddessen)	(1 times)
Werent	(Während)	(1 times)
Wieg	(Wie)	(1 times)
Wieleicht	(Vielleicht)	(1 times)
Wiesse	(Wiese)	(1 times)
Wilst	(Willst)	(1 times)
Wingte	(winkte)	(1 times)
Woch	(noch)	(1 times)
Wohnog	(Wohnung)	(2 times)
Wohnug	(Wohnung)	(1 times)
Wohnzemmer	(Wohnzimmer)	(1 times)
Wolte	(wollte)	(2 times)
Wonung	(Wohnung)	(3 times)
Wonzimer	(Wohnzimmer)	(1 times)
Wonzimmer	(Wohnzimmer)	(1 times)
Wrosch	(Frosch)	(1 times)
Wuste	(wusste)	(1 times)
Wärend	(Während)	(1 times)
Würklich	(Wirklich)	(1 times)
Zimer	(Zimmer)	(4 times)
Zimlick	(Ziemlich)	(1 times)
Zitrune	(Zitrone)	(1 times)
Zurük	(zurück)	(1 times)
Zwichendursch	(Zwischendurch)	(1 times)
a	(ah)	(1 times)
aP	(ab)	(1 times)
abeit	(Arbeit)	(1 times)
abeiten	(arbeiten)	(1 times)
aben	(haben)	(1 times)
abgeharte	(abgewartet)	(1 times)
abgehgehben	(abgegeben)	(1 times)
abgehuen	(abgehauen)	(1 times)
abgelengt	(abgelenkt)	(2 times)
abgerisen	(abgerissen)	(1 times)
abgipt	(abgibt)	(1 times)
abhaun	(abhauen)	(1 times)
abholln	(abholen)	(1 times)
absand	(Abstand)	(1 times)
ach	(auch)	(1 times)
ader	(aber)	(2 times)
adrese	(Adresse)	(5 times)
aein	(ein)	(2 times)
afaren	(erfahren)	(1 times)
ahben	(haben)	(1 times)
ahle	(alle)	(1 times)
ahn	(an)	(1 times)
ahngerufen	(angerufen)	(1 times)
ain	(ein)	(2 times)
ainer	(einer)	(1 times)
ais	(Eis)	(2 times)
ale	(Alle)	(1 times)
ale	(alle)	(20 times)
alein	(allein)	(3 times)
aleine	(alleine)	(3 times)
alen	(allen)	(1 times)
ales	(Alles)	(1 times)
ales	(alles)	(31 times)
allen	(allein)	(1 times)
allle	(alle)	(1 times)
alls	(als)	(6 times)
allte	(alte)	(1 times)
alsu	(also)	(1 times)
alz	(als)	(5 times)
amal	(einmal)	(2 times)
ameisten	(meisten)	(1 times)
amfang	(Anfang)	(1 times)
and	(und)	(5 times)
andaren	(anderen)	(2 times)
andauernt	(andauernd)	(1 times)
andereres	(anderes)	(1 times)
andre	(andere)	(3 times)
andren	(anderen)	(2 times)
andwort	(Antwort)	(2 times)
andwortet	(antwortet)	(2 times)
andwortete	(antwortete)	(1 times)
aneinnander	(aneinander)	(1 times)
aneruffen	(angerufen)	(1 times)
anfach	(einfach)	(1 times)
anfengt	(anfängt)	(1 times)
anfeufft	(anruft)	(1 times)
angeLomen	(angekommen)	(1 times)
angeckommen	(angekommen)	(1 times)
angefan	(angefangen)	(1 times)
angegomen	(angekommen)	(1 times)
angekomen	(angekommen)	(4 times)
angenomen	(angenommen)	(1 times)
angeommen	(angekommen)	(1 times)
angerand	(angerannt)	(2 times)
angerifen	(angerufen)	(1 times)
angerofen	(angerufen)	(1 times)
angerrufen	(angerufen)	(1 times)
angeruten	(angerufen)	(1 times)
angrufen	(angerufen)	(1 times)
angs	(Angst)	(3 times)
anhelt	(anhält)	(2 times)
ankahm	(ankam)	(1 times)
ankammen	(ankamen)	(1 times)
ankarm	(ankam)	(1 times)
ankekommen	(angekommen)	(1 times)
ankst	(Angst)	(1 times)
anmal	(einmal)	(3 times)
ann	(an)	(1 times)
anrufd	(anruft)	(1 times)
anruff	(Anruf)	(1 times)
anruffen	(anrufen)	(1 times)
anruft	(Anruf)	(1 times)
anruhf	(Anruf)	(1 times)
anruhft	(anruft)	(1 times)
anrut	(anruft)	(1 times)
anschlisend	(anschließend)	(1 times)
anseige	(Anzeige)	(1 times)
anst	(Angst)	(2 times)
antfortette	(antwortete)	(1 times)
anung	(Ahnung)	(4 times)
anwing	(anfing)	(1 times)
anz	(an)	(1 times)
anz	(ans)	(1 times)
ap	(ab)	(22 times)
apegeben	(abgegeben)	(1 times)
aperad	(Apparat)	(1 times)
as	(aus)	(1 times)
aschrak	(erschrak)	(1 times)
aschrekt	(erschreckt)	(1 times)
ate	(hatte)	(2 times)
atwas	(etwas)	(1 times)
atwortete	(antwortete)	(1 times)
au	(auf)	(1 times)
aub	(ob)	(1 times)
auch-	(auch)	(1 times)
auck	(auch)	(1 times)
auf-	(auf)	(2 times)
aufSchreiden	(aufschreiben)	(1 times)
aufachte	(aufwachte)	(1 times)
aufgade	(Aufgabe)	(1 times)
aufgebract	(aufgebracht)	(1 times)
aufgefahlen	(aufgefallen)	(1 times)
aufgefahllen	(aufgefallen)	(1 times)
aufgeh.passt	(aufgepasst)	(1 times)
aufgehangt	(aufgehängt)	(1 times)
aufgehstanden	(aufgestanden)	(2 times)
aufgemachnd	(aufgemacht)	(1 times)
aufgemmacht	(aufgemacht)	(1 times)
aufgepast	(aufgepasst)	(3 times)
aufgereckt	(aufgeregt)	(1 times)
aufgerekt	(aufgeregt)	(2 times)
aufgereumt	(aufgeräumt)	(2 times)
aufgeschdandenn	(aufgestanden)	(1 times)
aufgeschprungen	(aufgesprungen)	(1 times)
aufgeschriben	(aufgeschrieben)	(1 times)
aufhengen	(Aufhängen)	(1 times)
aufhengen	(aufhängen)	(5 times)
aufhoren	(aufhören)	(1 times)
aufpast	(aufpasst)	(2 times)
aufreumen	(aufräumen)	(2 times)
auft	(auf)	(1 times)
auftn	(auf)	(1 times)
auh	(auch)	(3 times)
aulz	(als)	(1 times)
aum	(um)	(1 times)
aunwol	(obwohl)	(1 times)
aus-	(aus)	(3 times)
ausbrobirt	(ausprobiert)	(1 times)
ause	(aus)	(1 times)
ausf	(auf)	(1 times)
ausgbrochen	(ausgebrochen)	(1 times)
ausgehstiegen	(ausgestiegen)	(1 times)
ausgelien	(ausgeliehen)	(1 times)
ausgeruncht	(ausgerutscht)	(1 times)
ausgerutcht	(ausgerutscht)	(2 times)
ausgesehn	(ausgesehen)	(1 times)
ausgestieben	(ausgestiegen)	(1 times)
ausgestigen	(ausgestiegen)	(1 times)
ausgewekset	(ausgewechselt)	(1 times)
ausgstigen	(ausgestiegen)	(1 times)
ausicht	(Aussicht)	(2 times)
ausnamsweise	(ausnahmsweise)	(1 times)
ausrichden	(ausrichten)	(1 times)
auss	(aus)	(2 times)
ausschteigen	(aussteigen)	(1 times)
aussied	(aussieht)	(1 times)
aussiet	(aussieht)	(1 times)
aussiht	(aussieht)	(1 times)
ausstgeigen	(aussteigen)	(1 times)
austeigen	(aussteigen)	(2 times)
auszieht	(aussieht)	(1 times)
auszurun	(auszuruhen)	(1 times)
auß	(aus)	(1 times)
außsteigen	(aussteigen)	(1 times)
awf	(auf)	(3 times)
awgeregt	(aufgeregt)	(1 times)
baar	(paar)	(1 times)
baei	(bei)	(1 times)
bai	(bei)	(1 times)
bann	(dann)	(1 times)
bant	(Band)	(2 times)
basiert	(passiert)	(2 times)
bauchscherzen	(Bauchschmerzen)	(1 times)
baues	(bauen)	(1 times)
bauhen	(bauen)	(2 times)
bauwen	(bauen)	(1 times)
beben	(Leben)	(1 times)
becKommen	(bekommen)	(1 times)
becheftigt	(beschäftigt)	(1 times)
beckam	(bekam)	(5 times)
beckomen	(bekommen)	(1 times)
beckommen	(bekommen)	(1 times)
bedancken	(bedanken)	(1 times)
bedangte	(bedankte)	(1 times)
bedannkt	(bedankt)	(1 times)
bedrukter	(bedrückter)	(1 times)
beemerckt	(bemerkt)	(1 times)
befastigt	(befestigt)	(1 times)
befegt	(bewegt)	(1 times)
befersdigen	(befestigen)	(1 times)
befesdigt	(befestigt)	(1 times)
befestikt	(befestigt)	(1 times)
befesttig	(befestigt)	(1 times)
befor	(bevor)	(3 times)
befästigt	(befestigt)	(5 times)
began	(begann)	(1 times)
begang	(begann)	(2 times)
beginen	(beginnen)	(2 times)
begingen	(beginnen)	(1 times)
beginnnen	(beginnen)	(1 times)
begint	(beginnt)	(1 times)
begonen	(begonnen)	(3 times)
begrif	(begriff)	(1 times)
begrust	(begrüßt)	(1 times)
begrüste	(begrüßte)	(1 times)
behahalte	(behalte)	(1 times)
behindet	(behindert)	(1 times)
behmerkt	(bemerkt)	(1 times)
beiben	(bleiben)	(1 times)
beil	(bei)	(1 times)
bein	(bei)	(1 times)
bein	(beim)	(1 times)
beinden	(beiden)	(1 times)
beischbiel	(Beispiel)	(1 times)
bekahm	(bekam)	(1 times)
bekamm	(bekam)	(4 times)
bekan	(bekam)	(1 times)
bekome	(bekomme)	(1 times)
bekomem	(bekommen)	(1 times)
bekomen	(bekommen)	(16 times)
bekomt	(bekommt)	(7 times)
belen	(Bellen)	(2 times)
belen	(bellen)	(8 times)
bellkte	(bellte)	(1 times)
beln	(bellen)	(1 times)
belt	(bellt)	(1 times)
beltte	(bellte)	(1 times)
bemegt	(bemerkt)	(2 times)
bemerckt	(bemerkt)	(2 times)
bemergt	(bemerkt)	(6 times)
bemerkde	(bemerkte)	(1 times)
bemmerkte	(bemerkte)	(1 times)
bemärgt	(bemerkt)	(1 times)
benk	(denk)	(1 times)
benuzt	(benutzt)	(1 times)
bereit's	(bereits)	(2 times)
berüren	(berühren)	(1 times)
beschefdigt	(beschäftigt)	(1 times)
bescheftigt	(beschäftigt)	(1 times)
bescheit	(Bescheid)	(2 times)
bescheit-	(Bescheid)	(1 times)
beschftigt	(beschäftigt)	(1 times)
beschlosen	(beschlossen)	(2 times)
beschstimt	(bestimmt)	(1 times)
beschtimt	(bestimmt)	(1 times)
beschtumt	(bestimmt)	(1 times)
besietzer	(Besitzer)	(1 times)
besorkt	(besorgt)	(1 times)
best	(beste)	(1 times)
bestelen	(bestellen)	(1 times)
bestim	(bestimmt)	(1 times)
bestimt	(bestimmt)	(8 times)
bestumt	(bestimmt)	(1 times)
besuh	(Besuch)	(1 times)
beultel	(Beutel)	(1 times)
beute	(Beutel)	(1 times)
beware	(bewahre)	(1 times)
bewaren	(bewahren)	(1 times)
beweckte	(bewegte)	(1 times)
bewekt	(bewegt)	(2 times)
bewogt	(bewegt)	(1 times)
bezaltzt	(bezahlst)	(1 times)
bezitzerin	(Besitzerin)	(1 times)
bezuch	(Besuch)	(1 times)
beängstigent	(beängstigend)	(1 times)
bichen	(bisschen)	(1 times)
bie	(bei)	(3 times)
bield	(Bild)	(2 times)
bielt	(Bild)	(1 times)
bies	(bis)	(6 times)
biesjen	(bisschen)	(1 times)
biessien	(bisschen)	(1 times)
biest	(bist)	(2 times)
biete	(bitte)	(1 times)
bilda	(Bilder)	(4 times)
bingt	(bringt)	(1 times)
bintet	(bindet)	(1 times)
birngt	(bringt)	(1 times)
biro	(Büro)	(1 times)
bishen	(bisschen)	(1 times)
bisitzerin	(Besitzerin)	(1 times)
bisjen	(bisschen)	(3 times)
biskien	(bisschen)	(1 times)
biss	(bis)	(8 times)
bissJen	(bisschen)	(1 times)
bisshen	(bisschen)	(1 times)
bissien	(bisschen)	(1 times)
bissirn	(bisschen)	(1 times)
bist	(bis)	(1 times)
bistimt	(bestimmt)	(2 times)
bite	(bitte)	(3 times)
bitt	(bitte)	(1 times)
bißchen	(bisschen)	(1 times)
blagate	(Plakate)	(3 times)
blakate	(Plakate)	(1 times)
blat	(Blatt)	(5 times)
blatst	(platzt)	(1 times)
bleb	(bleib)	(1 times)
bleit	(bleibt)	(1 times)
blendent	(blendend)	(2 times)
bletter	(Blätter)	(1 times)
blib	(blieb)	(1 times)
blig	(Blick)	(1 times)
bliken	(blicken)	(1 times)
blleter	(Blätter)	(1 times)
boben	(Boden)	(1 times)
boltel	(Beutel)	(2 times)
borg	(Burg)	(1 times)
boten	(Boden)	(1 times)
bracht	(brachte)	(1 times)
braust	(brauchst)	(2 times)
braußt	(brauchst)	(1 times)
brengen	(bringen)	(2 times)
briengt	(bringt)	(1 times)
brig	(bring)	(2 times)
brige	(bringe)	(2 times)
brigen	(bringen)	(1 times)
bringd	(bringt)	(1 times)
brinkt	(bringt)	(2 times)
brülen	(brüllen)	(1 times)
bscheftigt	(beschäftigt)	(1 times)
bschreibt	(beschreibt)	(1 times)
burk	(Burg)	(1 times)
buss	(Bus)	(1 times)
bällen	(bellen)	(1 times)
bäutel	(Beutel)	(1 times)
böltel	(Beutel)	(1 times)
böre	(böse)	(1 times)
cha	(ja)	(1 times)
chaben	(haben)	(2 times)
chon	(schon)	(1 times)
daan	(dann)	(2 times)
dabai	(dabei)	(1 times)
dabeiy	(dabei)	(1 times)
dabie	(dabei)	(1 times)
dach	(doch)	(1 times)
dachde	(dachte)	(2 times)
dache	(dachte)	(1 times)
dachin	(dahin)	(1 times)
dacht	(dachte)	(1 times)
dadchte	(dachte)	(1 times)
dafon	(davon)	(2 times)
dahnn	(dann)	(1 times)
dahte	(dachte)	(1 times)
dai	(bei)	(1 times)
dale	(dolle)	(1 times)
damid	(damit)	(1 times)
dammit	(damit)	(1 times)
dan	(dann)	(93 times)
danelem	(daneben)	(1 times)
danit	(damit)	(1 times)
dank	(danke)	(2 times)
dankar	(dankbar)	(1 times)
danke	(Dank)	(1 times)
danker	(danke)	(1 times)
dannach	(danach)	(6 times)
dannke	(danke)	(1 times)
danoch	(danach)	(1 times)
danse	(ganze)	(1 times)
daram	(daran)	(1 times)
darausen	(draußen)	(2 times)
darbei	(dabei)	(3 times)
darke	(danke)	(1 times)
darr	(da)	(1 times)
daruber	(darüber)	(2 times)
daruf	(darauf)	(1 times)
darun	(daran)	(1 times)
das	(dass)	(258 times)
dasrauf	(darauf)	(1 times)
dass	(Das)	(1 times)
dass	(das)	(36 times)
daswegen	(deswegen)	(4 times)
daute	(dauerte)	(1 times)
dauuste	(dauerte)	(1 times)
de	(der)	(1 times)
deann	(dann)	(1 times)
deck	(Dreck)	(1 times)
dedacht	(gedacht)	(1 times)
deen	(den)	(2 times)
degrüßen	(begrüßen)	(1 times)
dehn	(den)	(1 times)
dei	(bei)	(4 times)
deide	(beide)	(1 times)
dein	(den)	(1 times)
dem-	(dem)	(1 times)
demm	(dem)	(2 times)
dengt	(denkt)	(6 times)
denn	(den)	(69 times)
dennn	(den)	(1 times)
der-	(der)	(1 times)
dereckt	(direkt)	(1 times)
derkekt	(direkt)	(1 times)
dern	(den)	(1 times)
des	(das)	(2 times)
deuch	(durch)	(1 times)
deuldlih	(deutlich)	(1 times)
deurl	(doll)	(1 times)
di	(die)	(4 times)
dic	(dich)	(1 times)
dicht	(nicht)	(1 times)
diech	(dich)	(1 times)
diecken	(dicken)	(3 times)
diee	(die)	(1 times)
dieken	(dicken)	(2 times)
dier	(dir)	(3 times)
dierek	(direkt)	(1 times)
dierekt	(direkt)	(2 times)
diesma	(diesmal)	(1 times)
diken	(dicken)	(1 times)
direck	(direkt)	(2 times)
direckt	(direkt)	(1 times)
diregt	(direkt)	(2 times)
direnen	(drinnen)	(1 times)
dis	(bis)	(1 times)
dise	(diese)	(2 times)
disen	(diesen)	(7 times)
diser	(dieser)	(1 times)
dises	(dieses)	(1 times)
dish	(dich)	(1 times)
dm	(dem)	(3 times)
dn	(den)	(1 times)
dna	(dann)	(1 times)
do	(da)	(1 times)
doden	(Boden)	(1 times)
dolle	(doll)	(2 times)
don	(dann)	(1 times)
dord	(dort)	(1 times)
dorften	(durften)	(1 times)
dos	(das)	(1 times)
draf	(drauf)	(2 times)
drarußen	(draußen)	(1 times)
draufen	(draußen)	(1 times)
draurich	(traurig)	(1 times)
draurig	(traurig)	(1 times)
drausen	(draußen)	(49 times)
drefchen	(treffen)	(1 times)
drefen	(treffen)	(1 times)
dreg	(Dreck)	(1 times)
drekig	(dreckig)	(3 times)
drekt	(direkt)	(2 times)
dret	(dreht)	(1 times)
drinen	(drinnen)	(10 times)
drinn	(drin)	(2 times)
drit	(dritt)	(1 times)
drite	(dritte)	(1 times)
druckte	(drückte)	(1 times)
drustete	(tröstete)	(1 times)
drükt	(drückt)	(4 times)
dsiser	(dieser)	(1 times)
duchs	(durchs)	(1 times)
duchte	(dachte)	(1 times)
dumet	(damit)	(1 times)
dun	(dann)	(1 times)
durschgedred	(durchgedreht)	(1 times)
dus	(das)	(1 times)
dänkt	(denkt)	(1 times)
düch	(durch)	(1 times)
ebenfals	(ebenfalls)	(2 times)
ebensfals	(ebenfalls)	(1 times)
eckstra	(extra)	(1 times)
ecktrehr	(extra)	(1 times)
edwas	(etwas)	(1 times)
egarl	(egal)	(1 times)
egenwo	(irgendwo)	(1 times)
eggal	(egal)	(1 times)
egsploson	(Explosion)	(1 times)
egstra	(extra)	(1 times)
ehmannt	(jemand)	(1 times)
ei	(ein)	(4 times)
eie	(ein)	(1 times)
eie	(eine)	(1 times)
eien	(eine)	(1 times)
eiene	(eine)	(1 times)
eienen	(einen)	(1 times)
eigenlich	(eigentlich)	(1 times)
eigentich	(eigentlich)	(1 times)
eihnen	(einen)	(1 times)
eilich	(eilig)	(1 times)
eim	(ein)	(2 times)
eimal	(einmal)	(15 times)
eime	(eine)	(2 times)
eimen	(einen)	(1 times)
eineholt	(eingeholt)	(1 times)
einein	(einen)	(1 times)
eineir	(einer)	(1 times)
einenen	(einen)	(2 times)
einerr	(einer)	(1 times)
einfahch	(einfach)	(1 times)
einfahr	(einfach)	(1 times)
einfar	(einfach)	(1 times)
einfch-	(einfach)	(1 times)
einfehlt	(einfällt)	(1 times)
einferstanden	(einverstanden)	(1 times)
einffach	(einfach)	(1 times)
eingefannen	(eingefangen)	(1 times)
eingestigen	(eingestiegen)	(1 times)
einhollen	(einholen)	(3 times)
einkauftasch	(Einkaufstasche)	(1 times)
einmall	(einmal)	(11 times)
einmol	(einmal)	(1 times)
einnal	(einmal)	(1 times)
einnen	(einen)	(1 times)
einnes	(Eines)	(1 times)
einr	(einer)	(1 times)
einruft	(anruft)	(2 times)
einsigen	(einzigen)	(1 times)
einwach	(einfach)	(1 times)
einziege	(einzige)	(2 times)
eirem	(einem)	(1 times)
eise	(eine)	(1 times)
eiss	(Eis)	(1 times)
eistile	(Eisdiele)	(1 times)
eiß	(Eis)	(2 times)
ekstra	(extra)	(1 times)
eleichtat	(erleichtert)	(1 times)
emand	(jemand)	(1 times)
emer	(immer)	(1 times)
en	(ein)	(2 times)
encklich	(endlich)	(1 times)
ende-	(Ende)	(1 times)
endeckt	(entdeckt)	(2 times)
endegt	(entdeckt)	(2 times)
endekt	(entdeckt)	(1 times)
endschuldigen	(entschuldigen)	(1 times)
endspand	(entspannt)	(1 times)
endsparnt	(entspannt)	(1 times)
endwicht	(entwischt)	(1 times)
enem	(einem)	(1 times)
enen	(einen)	(2 times)
englich	(Endlich)	(1 times)
englich	(endlich)	(1 times)
enschuldigung	(Entschuldigung)	(1 times)
enschuldikt	(entschuldigt)	(1 times)
enstuldicken	(entschuldigen)	(1 times)
enstuldigung	(Entschuldigung)	(1 times)
entdeken	(entdecken)	(1 times)
entdekt	(entdeckt)	(1 times)
enteckt	(entdeckt)	(1 times)
enteucht	(enttäuscht)	(1 times)
enteuscht	(enttäuscht)	(1 times)
enteust	(enttäuscht)	(1 times)
entfrnte	(entfernte)	(1 times)
entgehgen	(entgegen)	(1 times)
entglich	(endlich)	(1 times)
entlich	(endlich)	(10 times)
entlig	(endlich)	(1 times)
entsetst	(entsetzt)	(1 times)
entteucht	(enttäuscht)	(1 times)
entteuscht	(enttäuscht)	(1 times)
entäuscht	(enttäuscht)	(2 times)
erckleren	(erklären)	(1 times)
ere	(ihre)	(1 times)
ereichen	(erreichen)	(1 times)
ereicht	(erreicht)	(3 times)
erenert	(erinnert)	(1 times)
erfaht	(erfahrt)	(1 times)
erfaren	(erfahren)	(1 times)
ergan	(ärgern)	(1 times)
ergendwo	(irgendwo)	(1 times)
erger	(Ärger)	(19 times)
ergerlich	(ärgerlich)	(1 times)
erleichtard	(erleichtert)	(1 times)
erleischtert	(erleichtert)	(1 times)
erleistert	(erleichtert)	(1 times)
err	(er)	(1 times)
ersaunt	(erstaunt)	(1 times)
erschrack	(erschrak)	(8 times)
erschrag	(erschrak)	(5 times)
erschrekte	(erschreckte)	(2 times)
erschtaund	(erstaunt)	(1 times)
ersehen	(Versehen)	(2 times)
erstand	(erstaunt)	(1 times)
eruicht	(erwischt)	(1 times)
ervolk	(Erfolg)	(1 times)
erwartungsfoll	(erwartungsvoll)	(1 times)
erwiederte	(erwiderte)	(1 times)
erwiedot	(erwidert)	(1 times)
erwist	(erwischt)	(1 times)
erzahld	(erzählt)	(1 times)
erzahlt	(erzählt)	(1 times)
erzelt	(erzählt)	(2 times)
est	(esst)	(4 times)
etlang	(entlang)	(1 times)
etwat	(etwas)	(1 times)
etwos	(etwas)	(1 times)
explodirt	(explodiert)	(1 times)
facht	(wacht)	(1 times)
fagt	(fragt)	(1 times)
fahlen	(fallen)	(1 times)
fahr	(war)	(1 times)
fahrren	(fahren)	(1 times)
fahrtet	(wartet)	(1 times)
falen	(fallen)	(3 times)
falln	(fallen)	(1 times)
faln	(fallen)	(3 times)
faloren	(verloren)	(4 times)
fals	(Falls)	(1 times)
fals	(falls)	(5 times)
famist	(vermisst)	(2 times)
fant	(fand)	(2 times)
faren	(Fahren)	(1 times)
faren	(fahren)	(3 times)
farlorene	(verlorene)	(1 times)
farmist	(vermisst)	(1 times)
farschwundene	(verschwundene)	(1 times)
farten	(warten)	(1 times)
farzeug	(Fahrzeug)	(1 times)
farückt	(verrückt)	(1 times)
farükt	(verrückt)	(1 times)
farükten	(Verrückten)	(1 times)
fasaucht	(versucht)	(1 times)
fasst	(fast)	(8 times)
fasucht	(versucht)	(1 times)
feg	(weg)	(2 times)
fegesen	(vergessen)	(3 times)
fehloren	(verloren)	(1 times)
fehlt	(fällt)	(8 times)
fehnster	(Fenster)	(4 times)
fehnsterbank	(Fensterbank)	(1 times)
fehrhindert	(verhindert)	(1 times)
fehrlang	(verlangt)	(1 times)
fehrlaufen	(verlaufen)	(1 times)
fehrloren	(verloren)	(1 times)
fehstalten	(festhalten)	(1 times)
feil	(weil)	(3 times)
feiter	(weiter)	(1 times)
feld	(fällt)	(4 times)
fellt	(fällt)	(7 times)
felt	(fällt)	(47 times)
fengd	(fängt)	(1 times)
fengen	(fangen)	(1 times)
fengt	(fängt)	(8 times)
fenserbank	(Fensterbank)	(1 times)
fensta	(Fenster)	(2 times)
fenste	(Fenster)	(2 times)
fenstehr	(Fenster)	(1 times)
fensterbang	(Fensterbank)	(1 times)
fenzder	(Fenster)	(1 times)
fenzter	(Fenster)	(2 times)
ferabschidet	(verabschiedet)	(1 times)
ferabschideten	(verabschiedeten)	(1 times)
feranstaltet	(veranstaltet)	(1 times)
ferchwunden	(verschwunden)	(1 times)
ferfen	(werfen)	(2 times)
ferfolgen	(verfolgen)	(1 times)
ferfolgt	(verfolgt)	(1 times)
ferfolgt-	(verfolgt)	(1 times)
ferfolkt	(verfolgt)	(1 times)
ferfängt	(verfängt)	(1 times)
fergaß	(vergaß)	(1 times)
fergisst	(vergisst)	(1 times)
fergist	(vergisst)	(5 times)
ferhindern	(verhindern)	(1 times)
ferhtich	(fertig)	(1 times)
ferjagt	(verjagt)	(1 times)
ferkessen	(vergessen)	(1 times)
ferkeufer	(Verkäufer)	(1 times)
ferkricht	(verkriecht)	(1 times)
ferletzt	(verletzt)	(3 times)
ferloren	(verloren)	(17 times)
ferlorene	(verlorene)	(5 times)
ferlätzt	(verletzt)	(1 times)
fermise	(vermisse)	(2 times)
fermist	(vermisst)	(18 times)
fermiste	(vermisste)	(1 times)
fermißt	(vermisst)	(1 times)
ferscheucht	(verscheucht)	(1 times)
fersehen	(Versehen)	(7 times)
fersehn	(Versehen)	(1 times)
fersen	(Versehen)	(1 times)
fersteckt	(versteckt)	(8 times)
fersteckte	(versteckte)	(1 times)
ferstegt	(versteckt)	(2 times)
ferstehen	(verstehen)	(1 times)
ferstehkt	(versteckt)	(1 times)
ferstek	(versteck)	(1 times)
ferstekt	(versteckt)	(4 times)
ferstekte	(versteckte)	(1 times)
ferstekten	(versteckten)	(1 times)
fersweifelt	(verzweifelt)	(1 times)
fert	(fährt)	(2 times)
ferteilt	(verteilt)	(1 times)
fertich	(fertig)	(2 times)
fertik	(fertig)	(2 times)
fertrau	(Vertrau)	(1 times)
ferzeihen	(verzeihen)	(1 times)
ferzweifelt	(verzweifelt)	(1 times)
ferükt	(verrückt)	(1 times)
fesst	(fest)	(1 times)
festalten	(festhalten)	(1 times)
festgehllten	(festgehalten)	(1 times)
feteilt	(verteilt)	(1 times)
feten	(fetten)	(1 times)
fetig	(fertig)	(1 times)
feude	(Freude)	(2 times)
fhenster	(Fenster)	(1 times)
fhnster	(Fenster)	(1 times)
fiartig	(fertig)	(2 times)
fidet	(findet)	(1 times)
fieder	(wieder)	(1 times)
fiel	(viel)	(5 times)
fiele	(viele)	(1 times)
fieleicht	(vielleicht)	(2 times)
fielen	(Vielen)	(1 times)
fieles	(vieles)	(1 times)
fiell	(viel)	(1 times)
fiellen	(vielen)	(1 times)
fiendet	(findet)	(2 times)
fienet	(findet)	(1 times)
fil	(fiel)	(1 times)
fil	(viel)	(1 times)
fileicht	(vielleicht)	(6 times)
filen	(vielen)	(1 times)
fill	(will)	(1 times)
findes	(findest)	(1 times)
fleicht	(vielleicht)	(1 times)
flickt	(fliegt)	(1 times)
fliehn	(fliehen)	(1 times)
fligen	(fliegen)	(3 times)
fliggt	(fliegt)	(1 times)
flikt	(fliegt)	(2 times)
flok	(flog)	(1 times)
flug	(flog)	(1 times)
flus	(Fluss)	(2 times)
flutst	(flutscht)	(1 times)
fnster	(Fenster)	(1 times)
fogel	(Vogel)	(5 times)
foler	(voller)	(2 times)
folkt	(folgt)	(2 times)
foll	(voll)	(4 times)
foller	(Voller)	(1 times)
fom	(vom)	(11 times)
fon	(von)	(42 times)
fonn	(von)	(1 times)
for	(vor)	(29 times)
forbei	(vorbei)	(10 times)
forh	(vor)	(1 times)
forne	(vorne)	(6 times)
forsichtig	(vorsichtig)	(5 times)
fote	(Pfote)	(1 times)
fourschwunden	(verschwunden)	(1 times)
frags	(fragt)	(1 times)
frahen	(fahren)	(1 times)
frakt	(fragt)	(1 times)
fraragte	(fragte)	(1 times)
fras	(fraß)	(3 times)
frass	(fraß)	(3 times)
frauen	(freuen)	(1 times)
fraut	(freut)	(2 times)
freede	(Freude)	(1 times)
freit	(freut)	(2 times)
freschen	(fressen)	(1 times)
fresen	(fressen)	(1 times)
fret	(freut)	(2 times)
freu	(Frau)	(1 times)
freud	(freut)	(7 times)
freude	(Freunde)	(1 times)
freuhen	(freuen)	(1 times)
freulich	(fröhlich)	(1 times)
freun	(Freund)	(1 times)
freund	(freut)	(1 times)
freunglich	(freundlich)	(1 times)
freunten	(freuten)	(1 times)
freusch	(Frosch)	(1 times)
freüte	(freute)	(1 times)
friche	(frische)	(1 times)
fris	(friss)	(1 times)
frist	(frisst)	(22 times)
frißt	(frisst)	(1 times)
fro	(froh)	(8 times)
froch	(Frosch)	(24 times)
froeit	(freut)	(1 times)
froeunde	(Freunde)	(2 times)
frohlich	(fröhlich)	(4 times)
frohlig	(fröhlich)	(1 times)
froien	(freuen)	(1 times)
froin	(freuen)	(1 times)
froint	(Freund)	(2 times)
frojt	(freut)	(1 times)
frolich	(fröhlich)	(1 times)
frolig	(fröhlich)	(1 times)
frond	(Freund)	(1 times)
fronden	(Freundin)	(1 times)
frout	(freut)	(1 times)
froyde	(Freude)	(1 times)
frsucht	(versucht)	(1 times)
frude	(Freude)	(1 times)
fruh	(früh)	(1 times)
fröchlich	(fröhlich)	(1 times)
fröde	(Freude)	(1 times)
frölich	(fröhlich)	(21 times)
fröliches	(fröhliches)	(1 times)
frölig	(fröhlich)	(1 times)
früen	(frühen)	(1 times)
frühlich	(fröhlich)	(2 times)
frühlig	(fröhlich)	(1 times)
frülisch	(fröhlich)	(1 times)
früt	(freut)	(2 times)
fun	(von)	(1 times)
fungzuniert	(funktioniert)	(1 times)
funkistonirt	(funktioniert)	(1 times)
fuste	(wusste)	(1 times)
futer	(Futter)	(6 times)
fählt	(fällt)	(2 times)
fähren	(fahren)	(1 times)
fährtich	(fertig)	(1 times)
fäht	(fährt)	(1 times)
fäld	(fällt)	(3 times)
fält	(fällt)	(15 times)
fänkt	(fängt)	(1 times)
färletzt	(verletzt)	(1 times)
färtich	(fertig)	(1 times)
fässt	(fest)	(1 times)
fäst	(fest)	(2 times)
fästgebunden	(festgebunden)	(1 times)
fölich	(fröhlich)	(1 times)
fötchen	(Pfötchen)	(1 times)
fü	(für)	(1 times)
füchterlich	(fürchterlich)	(1 times)
fühen	(frühen)	(1 times)
führ	(für)	(2 times)
fülen	(fühlen)	(1 times)
fürsterlich	(fürchterlich)	(1 times)
gaa	(gar)	(1 times)
gafeurt	(gefreut)	(1 times)
gahb	(gab)	(1 times)
gamen	(kamen)	(1 times)
gan	(ganz)	(1 times)
gan	(kann)	(1 times)
gane	(ganz)	(1 times)
gann	(kann)	(1 times)
gannse	(ganze)	(1 times)
gans	(ganz)	(24 times)
ganse	(ganze)	(5 times)
gansen	(ganzen)	(1 times)
gansse	(ganze)	(1 times)
gantze	(ganze)	(2 times)
gantzen	(ganzen)	(1 times)
ganzt	(ganz)	(1 times)
ganß	(ganz)	(1 times)
gap	(gab)	(1 times)
garade	(gerade)	(1 times)
gasi	(Gassi)	(1 times)
gassie	(Gassi)	(1 times)
gaze	(ganze)	(1 times)
gdacht	(gedacht)	(1 times)
gebanken	(Gedanken)	(1 times)
gebat	(gebaut)	(1 times)
gebelt	(gebellt)	(17 times)
geblatz	(geplatzt)	(1 times)
geblatzt	(geplatzt)	(1 times)
gebliben	(geblieben)	(3 times)
gebliden	(geblieben)	(1 times)
gebrach	(gebracht)	(4 times)
gebrat	(gebracht)	(1 times)
geburstag	(Geburtstag)	(2 times)
gebutstag	(Geburtstag)	(1 times)
gechen	(gehen)	(2 times)
gechprungen	(gesprungen)	(1 times)
gecht	(geht)	(1 times)
geckangen	(gegangen)	(1 times)
geckauft	(gekauft)	(1 times)
gecken	(gegen)	(1 times)
gecklaut	(geklaut)	(1 times)
geckomen	(gekommen)	(3 times)
geckommen	(gekommen)	(3 times)
gedruckt	(gedrückt)	(1 times)
gedrügt	(gedrückt)	(1 times)
gedrükt	(gedrückt)	(1 times)
geduldigt	(geduldig)	(1 times)
geemacht	(gemacht)	(1 times)
gef=unden	(gefunden)	(1 times)
gefahlen	(gefallen)	(4 times)
gefahrat	(gefragt)	(1 times)
gefalen	(gefallen)	(32 times)
gefalln	(gefallen)	(2 times)
gefaln	(gefallen)	(1 times)
gefanden	(gefunden)	(1 times)
gefange	(gefangen)	(1 times)
gefaren	(gefahren)	(4 times)
gefarnt	(gewarnt)	(1 times)
gefast	(gefasst)	(1 times)
gefelt	(gefällt)	(3 times)
geffaen	(gefallen)	(1 times)
geffalen	(gefallen)	(2 times)
geffallen	(gefallen)	(1 times)
geffeurt	(gefreut)	(1 times)
geffunden	(gefunden)	(1 times)
gefohnden	(gefunden)	(1 times)
gefolkt	(gefolgt)	(2 times)
gefonden	(gefunden)	(1 times)
geforden	(geworden)	(1 times)
geforünd	(gefreut)	(1 times)
gefracht	(gefragt)	(1 times)
gefrag	(gefragt)	(1 times)
gefreud	(gefreut)	(3 times)
gefrofen	(getroffen)	(1 times)
gefroit	(gefreut)	(1 times)
gefrojt	(gefreut)	(1 times)
gefrut	(gefreut)	(1 times)
gefrät	(gefreut)	(1 times)
gefründt	(gefreut)	(1 times)
gefuden	(gefunden)	(3 times)
gefuhnden	(gefunden)	(1 times)
gefunde	(gefunden)	(3 times)
gefunen	(gefunden)	(3 times)
gefunten	(gefunden)	(1 times)
gefönden	(gefunden)	(1 times)
gefül	(Gefühl)	(3 times)
gegagen	(gegangen)	(1 times)
gegancken	(gegangen)	(1 times)
geganden	(gegangen)	(1 times)
geganen	(gegangen)	(2 times)
gegang	(gegangen)	(1 times)
gegange	(gegangen)	(2 times)
gegannen	(gegangen)	(3 times)
gegeden	(gegeben)	(1 times)
gegegesen	(gegessen)	(1 times)
gegend	(gegen)	(1 times)
gegendt	(gegen)	(1 times)
gegesen	(gegessen)	(2 times)
gegiben	(gegeben)	(1 times)
gegkommen	(gekommen)	(1 times)
geglingelnd	(geklingelt)	(1 times)
geglingelt	(geklingelt)	(1 times)
gegomen	(gekommen)	(1 times)
gegongen	(gegangen)	(1 times)
gehabd	(gehabt)	(1 times)
gehben	(Geben)	(1 times)
gehbliben	(geblieben)	(1 times)
gehdacht	(gedacht)	(1 times)
gehefalen	(gefallen)	(2 times)
gehegeheben	(gegeben)	(1 times)
gehekomen	(gekommen)	(1 times)
gehen-	(gehen)	(1 times)
gehfahr	(Gefahr)	(1 times)
gehfalen	(gefallen)	(1 times)
gehfallen	(gefallen)	(1 times)
gehfunden	(gefunden)	(2 times)
gehgangen	(gegangen)	(6 times)
gehgehn	(gegen)	(1 times)
gehhabt	(gehabt)	(1 times)
gehhört	(gehört)	(1 times)
gehkomen	(gekommen)	(1 times)
gehkommen	(gekommen)	(1 times)
gehlacht	(gelacht)	(1 times)
gehlaufen	(gelaufen)	(1 times)
gehlekt	(gelegt)	(2 times)
gehmacht	(gemacht)	(2 times)
gehmensem	(gemeinsam)	(1 times)
gehn	(gehen)	(2 times)
gehnohmen	(genommen)	(1 times)
gehold	(geholt)	(1 times)
gehort	(gehört)	(5 times)
gehrade	(gerade)	(2 times)
gehrant	(gerannt)	(1 times)
gehsagt	(gesagt)	(4 times)
gehsehen	(gesehen)	(14 times)
gehsehn	(gesehen)	(3 times)
gehstorben	(gestorben)	(1 times)
gehult	(geholt)	(1 times)
gehupft	(gehüpft)	(2 times)
gehurt	(gehört)	(1 times)
gehörte	(gehört)	(1 times)
geisth	(Geist)	(1 times)
gekanken	(gegangen)	(1 times)
gekaut	(gekauft)	(2 times)
gekilinelt	(geklingelt)	(1 times)
geklept	(geklebt)	(1 times)
geklingeld	(geklingelt)	(1 times)
geklingetlt	(geklingelt)	(1 times)
gekloppft	(geklopft)	(1 times)
geknalt	(geknallt)	(1 times)
gekomen	(gekommen)	(10 times)
gekommem	(gekommen)	(1 times)
gekommmen	(gekommen)	(1 times)
gekrabelt	(gekrabbelt)	(4 times)
gekrickt	(gekriegt)	(1 times)
gekriclt	(gekriegt)	(1 times)
gekrigt	(gekriegt)	(1 times)
gekringelt	(geklingelt)	(1 times)
gekuchelt	(gekuschelt)	(1 times)
gelanded	(gelandet)	(1 times)
gelanweilt	(gelangweilt)	(1 times)
gelasen	(gelassen)	(3 times)
gelechilt	(gelächelt)	(1 times)
geleichzeitich	(gleichzeitig)	(1 times)
gelet	(gelegt)	(1 times)
gelt	(Geld)	(4 times)
gelöcklich	(glücklich)	(1 times)
gemach	(gemacht)	(3 times)
gemaldet	(gemeldet)	(1 times)
gemeinsan	(gemeinsam)	(1 times)
gemeisam	(gemeinsam)	(1 times)
gemucklich	(gemütlich)	(1 times)
gemuglich	(gemütlich)	(1 times)
gemutlich	(gemütlich)	(1 times)
gen	(gehen)	(13 times)
generft	(genervt)	(1 times)
gengen	(gegen)	(1 times)
geniest	(genießt)	(1 times)
genist	(genießt)	(1 times)
genomen	(genommen)	(20 times)
genuch	(genug)	(1 times)
genuk	(genug)	(1 times)
genärft	(genervt)	(1 times)
genüslich	(genüsslich)	(1 times)
gepagt	(gepackt)	(1 times)
gerada	(gerade)	(1 times)
gerand	(gerannt)	(5 times)
gerant	(gerannt)	(4 times)
gerauschen	(Geräuschen)	(1 times)
gerechnete	(gerechnet)	(1 times)
gerechnit	(gerechnet)	(1 times)
gereded	(geredet)	(1 times)
geretet	(gerettet)	(1 times)
gereuch	(Geräusch)	(1 times)
gereuche	(Geräusche)	(2 times)
gereuchen	(Geräuschen)	(1 times)
gereusch	(Geräusch)	(2 times)
gerissin	(gerissen)	(1 times)
gerißen	(gerissen)	(1 times)
geruscht	(gerutscht)	(1 times)
gerutcht	(gerutscht)	(1 times)
geruttscht	(gerutscht)	(1 times)
gesaagt	(gesagt)	(2 times)
gesack	(gesagt)	(1 times)
gesackt	(gesagt)	(7 times)
gesag	(gesagt)	(3 times)
gesaght	(gesagt)	(1 times)
gesahgt	(gesagt)	(1 times)
gesakkt	(gesagt)	(1 times)
gesakt	(gesagt)	(3 times)
gesaupt	(gesaugt)	(1 times)
gescha	(geschah)	(2 times)
geschaft	(geschafft)	(22 times)
geschang	(Geschenk)	(1 times)
geschar	(geschah)	(1 times)
geschbrungen	(gesprungen)	(5 times)
gescheft	(Geschäft)	(2 times)
geschek	(Geschenk)	(1 times)
geschemt	(geschämt)	(1 times)
gescheng	(Geschenk)	(1 times)
geschenk	(geschenkt)	(1 times)
geschieben	(geschrieben)	(1 times)
geschikt	(geschickt)	(1 times)
geschimft	(geschimpft)	(1 times)
geschiste	(Geschichte)	(1 times)
geschmizen	(geschmissen)	(1 times)
geschnapt	(geschnappt)	(3 times)
geschokt	(geschockt)	(1 times)
geschpielt	(gespielt)	(2 times)
geschprongen	(gesprungen)	(1 times)
geschprugen	(gesprungen)	(1 times)
geschprungen	(gesprungen)	(1 times)
geschreiben	(geschrieben)	(1 times)
geschreibien	(geschrieben)	(1 times)
geschriben	(geschrieben)	(5 times)
geschteld	(gestellt)	(1 times)
geschtorben	(gestorben)	(2 times)
geschwindikeit	(Geschwindigkeit)	(1 times)
geschänk	(Geschenk)	(1 times)
geschümpft	(geschimpft)	(1 times)
geseh	(gesehen)	(1 times)
gesehe	(gesehen)	(1 times)
gesehn	(gesehen)	(15 times)
gesehon	(gesehen)	(1 times)
gesen	(gesehen)	(28 times)
gesest	(gesetzt)	(1 times)
gesichte	(Geschichte)	(1 times)
gesogen	(gezogen)	(1 times)
gespand	(gespannt)	(2 times)
gespant	(gespannt)	(5 times)
gespante	(gespannte)	(1 times)
gespiel	(gespielt)	(1 times)
gespild	(gespielt)	(1 times)
gesprun.gen	(gesprungen)	(1 times)
gesprung	(gesprungen)	(1 times)
gesprungn	(gesprungen)	(1 times)
gespungen	(gesprungen)	(1 times)
gessagt	(gesagt)	(1 times)
gesscheng	(Geschenk)	(1 times)
gessehen	(gesehen)	(2 times)
gestan	(gestern)	(1 times)
gesteld	(gestellt)	(1 times)
gestelt	(gestellt)	(11 times)
gester	(gestern)	(1 times)
gestigen	(gestiegen)	(4 times)
gestoben	(gestorben)	(2 times)
gestolbert	(gestolpert)	(1 times)
gestolper	(gestolpert)	(1 times)
gestroben	(gestorben)	(1 times)
gesuchd	(gesucht)	(1 times)
get	(geht)	(25 times)
getahn	(getan)	(4 times)
geteit	(geteilt)	(1 times)
geth	(geht)	(1 times)
getofen	(getroffen)	(1 times)
getriten	(getreten)	(1 times)
getrofen	(getroffen)	(10 times)
getruken	(getrunken)	(1 times)
gettrent	(getrennt)	(1 times)
gettrofen	(getroffen)	(1 times)
gevallen	(gefallen)	(1 times)
gevunden	(gefunden)	(1 times)
gewackeld	(gewackelt)	(1 times)
gewart	(gewarnt)	(1 times)
gewegt	(geweckt)	(1 times)
geweit	(geweint)	(1 times)
gewese	(gewesen)	(1 times)
geworffen	(geworfen)	(2 times)
gewundat	(gewundert)	(1 times)
gewunden	(gefunden)	(4 times)
gewunder	(gewundert)	(1 times)
gewunderd	(gewundert)	(1 times)
gewust	(gewusst)	(1 times)
gezegt	(gezeigt)	(1 times)
gezeickt	(gezeigt)	(1 times)
gezoge	(gezogen)	(1 times)
geöfnet	(geöffnet)	(2 times)
gfragt	(gefragt)	(1 times)
gfreut	(gefreut)	(2 times)
gfunden	(gefunden)	(4 times)
ghesen	(gesehen)	(1 times)
gibs	(gibts)	(1 times)
gieb	(gib)	(1 times)
giebt	(gibt)	(12 times)
gieng	(ging)	(1 times)
giept	(gibt)	(1 times)
gig	(ging)	(1 times)
gigen	(gingen)	(1 times)
gigessen	(gegessen)	(2 times)
gink	(ging)	(1 times)
ginken	(gingen)	(1 times)
gipbi	(gibt)	(1 times)
gipt	(gibt)	(10 times)
git	(geht)	(1 times)
glacklich	(glücklich)	(1 times)
glaich	(gleich)	(1 times)
glaiech	(gleich)	(1 times)
glebt	(klebt)	(1 times)
glei	(gleich)	(1 times)
gleisch	(gleich)	(2 times)
glich	(gleich)	(1 times)
glingelt	(klingelt)	(1 times)
gloklich	(glücklich)	(1 times)
gluKlich	(glücklich)	(1 times)
gluchlich	(glücklich)	(1 times)
gluck	(Glück)	(4 times)
glucklich	(glücklich)	(9 times)
gluglich	(glücklich)	(4 times)
gluglis=ch	(glücklich)	(1 times)
gluk	(Glück)	(2 times)
gluklesch	(glücklich)	(1 times)
gluklich	(glücklich)	(5 times)
glüKlich	(glücklich)	(1 times)
glüchklich	(glücklich)	(1 times)
glüchlich	(glücklich)	(1 times)
glücklic	(glücklich)	(1 times)
glücklig	(glücklich)	(4 times)
glücklisch	(glücklich)	(1 times)
glüg	(Glück)	(2 times)
glüglich	(glücklich)	(17 times)
glüglis	(glücklich)	(1 times)
glüglist	(glücklich)	(1 times)
glügrich	(glücklich)	(1 times)
glühg	(Glück)	(1 times)
glük	(Glück)	(3 times)
glükclich	(glücklich)	(1 times)
glükich	(glücklich)	(1 times)
glüklch	(glücklich)	(2 times)
glüklich	(glücklich)	(48 times)
glüklieg	(glücklich)	(1 times)
glüklisch	(glücklich)	(1 times)
gmelde	(gemeldet)	(1 times)
gnalte	(knallte)	(1 times)
gom	(komm)	(1 times)
gomt	(kommt)	(2 times)
grabe	(grade)	(1 times)
grgern	(ärgern)	(1 times)
griegst	(kriegst)	(1 times)
grif	(Griff)	(1 times)
grif	(griff)	(1 times)
grin	(drin)	(1 times)
grolt	(gerollt)	(1 times)
grose	(große)	(2 times)
grosen	(großen)	(1 times)
gruklich	(glücklich)	(1 times)
grönen	(grünen)	(1 times)
gröser	(größer)	(2 times)
grücken	(drücken)	(1 times)
grücklich	(glücklich)	(1 times)
gsagt	(gesagt)	(1 times)
gu	(zu)	(1 times)
guab	(gab)	(1 times)
gucgt	(guckt)	(1 times)
gud	(gut)	(1 times)
gug	(guck)	(1 times)
gugt	(guckt)	(5 times)
guk	(guck)	(1 times)
gukc	(guck)	(1 times)
gukt	(guckt)	(1 times)
gulücklich	(glücklich)	(1 times)
gönau	(genau)	(1 times)
gükt	(guckt)	(1 times)
gülücklich	(glücklich)	(1 times)
haber	(aber)	(1 times)
hacken	(Haken)	(1 times)
had	(hat)	(1 times)
hade	(habe)	(5 times)
haden	(haben)	(6 times)
hadt	(hat)	(1 times)
hadte	(hatte)	(1 times)
haeimlich	(heimlich)	(1 times)
hag	(hab)	(1 times)
hak	(hat)	(1 times)
hal	(hat)	(1 times)
hale	(habe)	(4 times)
halen	(haben)	(1 times)
hall	(hallo)	(1 times)
hallten	(halten)	(3 times)
halltet	(haltet)	(3 times)
hals	(als)	(1 times)
halsbant	(Halsband)	(1 times)
haltan	(halten)	(1 times)
halteStäle	(Haltestelle)	(1 times)
haltehelle	(Haltestelle)	(1 times)
haltestele	(Haltestelle)	(2 times)
haltsband	(Halsband)	(1 times)
halzBand	(Halsband)	(1 times)
halzband	(Halsband)	(1 times)
halzbant	(Halsband)	(1 times)
hand	(hat)	(20 times)
handen	(Händen)	(1 times)
hannd	(hat)	(1 times)
hant	(Hand)	(13 times)
hap	(hab)	(5 times)
hapen	(haben)	(1 times)
har	(hat)	(1 times)
has	(hast)	(1 times)
hasst	(hast)	(4 times)
hate	(hatte)	(136 times)
haten	(hatten)	(1 times)
hatet	(hattet)	(2 times)
hatetn	(hatten)	(1 times)
hatt	(hat)	(50 times)
haubtsach	(Hauptsache)	(1 times)
hauch	(auch)	(1 times)
hausabeit	(Hausarbeit)	(1 times)
haustur	(Haustür)	(1 times)
hebe	(habe)	(1 times)
hecktig	(hektisch)	(1 times)
hecktisch	(hektisch)	(1 times)
heer	(her)	(1 times)
heimlisch	(heimlich)	(1 times)
heiputzutage	(heutzutage)	(1 times)
heise	(heiße)	(1 times)
heisen	(heißen)	(2 times)
heislen	(heißen)	(1 times)
heist	(heißt)	(6 times)
helfte	(Hälfte)	(2 times)
hellt	(hält)	(1 times)
helt	(hält)	(9 times)
helte	(Hälfte)	(1 times)
heltet	(haltet)	(1 times)
heltt	(hält)	(1 times)
hemand	(jemand)	(1 times)
hen	(hin)	(1 times)
hende	(Hände)	(1 times)
henden	(Händen)	(1 times)
hendi	(Handy)	(1 times)
hengen	(hängen)	(3 times)
hengt	(hängt)	(10 times)
henkt	(hängt)	(17 times)
henterher	(hinterher)	(1 times)
hepy	(happy)	(1 times)
heras	(heraus)	(1 times)
herau	(heraus)	(2 times)
herauß	(heraus)	(1 times)
herchen	(Herrchen)	(1 times)
herlich	(herrlich)	(1 times)
herlichen	(herrlichen)	(2 times)
herraus	(heraus)	(3 times)
herrein	(herein)	(7 times)
herrunder	(herunter)	(2 times)
hette	(hätte)	(1 times)
hibt	(hebt)	(1 times)
hicht	(nicht)	(1 times)
hie	(hier)	(1 times)
hield	(hielt)	(1 times)
hielft	(hilft)	(1 times)
hiengesest	(hingesetzt)	(1 times)
hienter	(hinter)	(4 times)
hienterher	(hinterher)	(1 times)
hienunter	(hinunter)	(1 times)
hies	(hieß)	(2 times)
hilt	(hielt)	(1 times)
hinain	(hinein)	(1 times)
hinder	(hinter)	(1 times)
hinderher	(hinterher)	(1 times)
hiner	(hinter)	(1 times)
hingesellt	(hingestellt)	(1 times)
hingeselt	(hingestellt)	(1 times)
hingesest	(hingesetzt)	(1 times)
hinggefallen	(hingefallen)	(1 times)
hinnsetzen	(hinsetzen)	(2 times)
hinser	(hinter)	(1 times)
hinsetsen	(hinsetzen)	(3 times)
hint	(hinter)	(1 times)
hinta	(hinter)	(4 times)
hinte	(hinter)	(4 times)
hinteher	(hinterher)	(1 times)
hinterbeinwe	(Hinterbeine)	(1 times)
hinterheher	(hinterher)	(1 times)
hinterhir	(hinterher)	(1 times)
hintern	(hinter)	(1 times)
hirhin	(hierhin)	(1 times)
hiter	(hinter)	(4 times)
hiterher	(hinterher)	(1 times)
hitfe	(Hilfe)	(1 times)
hlten	(halten)	(1 times)
hofe	(hoffe)	(1 times)
hofentlich	(hoffentlich)	(1 times)
hoffentliel	(hoffentlich)	(1 times)
hoffnug	(Hoffnung)	(1 times)
hofnung	(Hoffnung)	(4 times)
hoft	(hofft)	(2 times)
hofte	(hoffte)	(2 times)
hollen	(holen)	(1 times)
hon	(schon)	(1 times)
hond	(Hand)	(1 times)
horen	(hören)	(1 times)
horer	(Hörer)	(1 times)
hosee	(Hose)	(1 times)
hot	(hat)	(1 times)
ht	(hat)	(2 times)
hta	(hat)	(2 times)
htte	(hatte)	(1 times)
hund	(Hand)	(1 times)
hunde-	(Hunde)	(1 times)
hunga	(Hunger)	(1 times)
hunge	(Hunger)	(1 times)
hungel	(Hunger)	(1 times)
hungrieg	(hungrig)	(1 times)
hunrig	(hungrig)	(4 times)
hunt	(Hund)	(3 times)
huse	(Hause)	(2 times)
hut	(hat)	(1 times)
hällt	(hält)	(2 times)
hänkt	(hängt)	(6 times)
häpt	(hebt)	(1 times)
hät	(hat)	(1 times)
häte	(hätte)	(4 times)
höen	(hören)	(1 times)
hübpft	(hüpft)	(1 times)
icht	(ich)	(1 times)
iem	(ihm)	(1 times)
iemm	(ihm)	(1 times)
ien	(ihn)	(1 times)
ier	(ihr)	(3 times)
iere	(ihre)	(1 times)
ieren	(ihren)	(4 times)
iergentwas	(irgendwas)	(1 times)
iher	(ihre)	(1 times)
ihm	(im)	(5 times)
ihmer	(immer)	(1 times)
ihrgendwo	(irgendwo)	(1 times)
ihrgentein	(irgendein)	(1 times)
ihrgentwann	(irgendwann)	(1 times)
iht	(ihm)	(1 times)
iich	(ich)	(1 times)
im-	(im)	(1 times)
ima	(immer)	(1 times)
imer	(immer)	(39 times)
imer-	(immer)	(1 times)
imern	(immer)	(1 times)
imm	(im)	(2 times)
imma	(immer)	(1 times)
in-	(in)	(1 times)
inSpand	(entspannt)	(1 times)
ind	(in)	(3 times)
inden	(indem)	(1 times)
indere	(andere)	(1 times)
inen	(ihnen)	(1 times)
inenStahd	(Innenstadt)	(1 times)
inn	(in)	(1 times)
innen	(ihnen)	(1 times)
inner	(immer)	(1 times)
interesant	(interessant)	(1 times)
intrisert	(interessiert)	(1 times)
inz	(ins)	(3 times)
inzwichen	(inzwischen)	(1 times)
ir	(ihr)	(6 times)
ire	(ihre)	(6 times)
irem	(ihrem)	(7 times)
iren	(ihren)	(18 times)
irer	(ihrer)	(4 times)
irgendwan	(irgendwann)	(1 times)
irgentwan	(irgendwann)	(2 times)
irgentwas	(irgendwas)	(2 times)
irgentwi	(irgendwie)	(1 times)
irgentwie	(irgendwie)	(1 times)
irgentwohin	(irgendwohin)	(2 times)
irhe	(ihre)	(2 times)
irhen	(ihren)	(3 times)
isch	(ich)	(3 times)
isd	(ist)	(2 times)
ish	(ich)	(1 times)
isr	(ist)	(1 times)
isst	(ist)	(4 times)
istn	(ist)	(1 times)
j	(ja)	(1 times)
jagd	(jagt)	(2 times)
jahrkt	(jagt)	(1 times)
jake	(Jacke)	(5 times)
jakt	(jagt)	(1 times)
jeda	(jeder)	(4 times)
jedz	(jetzt)	(1 times)
jemaand	(jemand)	(1 times)
jemamd	(jemand)	(1 times)
jeman	(jemand)	(4 times)
jemana	(jemand)	(1 times)
jemang	(jemand)	(1 times)
jemannd	(jemand)	(2 times)
jemant	(jemand)	(10 times)
jemat	(jemand)	(2 times)
jemmand	(jemand)	(3 times)
jest	(jetzt)	(6 times)
jetz	(jetzt)	(14 times)
jetztt	(jetzt)	(1 times)
jezt	(jetzt)	(10 times)
jmant	(jemand)	(1 times)
k.no	(Kino)	(1 times)
ka	(kann)	(2 times)
kaPut	(kaputt)	(1 times)
kabunt	(kaputt)	(1 times)
kaeiner	(keiner)	(1 times)
kafen	(kaufen)	(2 times)
kahm	(kam)	(1 times)
kahn	(kann)	(2 times)
kainer	(keiner)	(1 times)
kamm	(kam)	(15 times)
kammen	(kamen)	(1 times)
kan	(kann)	(31 times)
kanm	(kann)	(1 times)
kanp	(knapp)	(1 times)
kanst	(Kannst)	(1 times)
kanst	(kannst)	(13 times)
kante	(kannte)	(3 times)
kapf	(Kopf)	(1 times)
kapot	(kaputt)	(2 times)
kappunt	(kaputt)	(1 times)
kapput	(kaputt)	(9 times)
kappute	(kaputte)	(4 times)
kapputt	(kaputt)	(1 times)
kapputte	(kaputte)	(1 times)
kapum	(kaputt)	(1 times)
kapurt	(kaputt)	(1 times)
kaput	(kaputt)	(79 times)
kapute	(kaputte)	(13 times)
kaputes	(kaputtes)	(1 times)
kaputgegahngen	(kaputtgegangen)	(1 times)
kaputgegangen	(kaputtgegangen)	(2 times)
karn	(kann)	(1 times)
kartank	(Karton)	(1 times)
kartong	(Karton)	(8 times)
katog	(Karton)	(1 times)
katon	(Karton)	(1 times)
keckse	(Kekse)	(3 times)
kefloken	(geflogen)	(1 times)
kefunden	(gefunden)	(2 times)
keina	(keiner)	(2 times)
keine	(kleine)	(1 times)
keines	(kleines)	(1 times)
keinner	(keiner)	(1 times)
kenn	(kann)	(1 times)
kete	(Kette)	(2 times)
kieste	(Kiste)	(3 times)
kilingelt	(klingelt)	(1 times)
kinda	(Kinder)	(1 times)
kinde	(Kinder)	(1 times)
kingelt	(klingelt)	(1 times)
kinglte	(klingelte)	(1 times)
klabt	(klappt)	(1 times)
klabte	(klappte)	(1 times)
klapen	(klappen)	(2 times)
klapfte	(klopfte)	(1 times)
klapt	(klappt)	(1 times)
klass	(Klasse)	(1 times)
klassenzimer	(Klassenzimmer)	(1 times)
kleich	(gleich)	(1 times)
klengelt	(klingelt)	(2 times)
kleppt	(klebt)	(1 times)
kletert	(klettert)	(4 times)
kliegelt	(klingelt)	(1 times)
klienelt	(klingelt)	(1 times)
kliengeln	(klingeln)	(1 times)
kliengelt	(klingelt)	(4 times)
kliengelte	(klingelte)	(2 times)
kligeld	(klingelt)	(1 times)
kligelt	(klingelt)	(8 times)
kliget	(klingelt)	(2 times)
klinelt	(klingelt)	(1 times)
klingeld	(klingelt)	(6 times)
klingell	(klingelt)	(1 times)
klinget	(klingelt)	(1 times)
klinngeln	(Klingeln)	(1 times)
kloft	(klopft)	(1 times)
kluklich	(glücklich)	(1 times)
kmochen	(Knochen)	(1 times)
knal	(Knall)	(2 times)
knalte	(knallte)	(15 times)
knaltte	(knallte)	(1 times)
knap	(knapp)	(1 times)
kneilte	(knallte)	(1 times)
knoche	(Knochen)	(1 times)
knochenn	(Knochen)	(1 times)
kobf	(Kopf)	(1 times)
kom	(Komm)	(1 times)
kom	(komm)	(6 times)
komd	(kommt)	(2 times)
kome	(komme)	(3 times)
komen	(kommen)	(10 times)
kommaen	(kommen)	(1 times)
kommmt	(kommt)	(1 times)
komomt	(kommt)	(1 times)
komst	(kommst)	(2 times)
komt	(kommt)	(40 times)
konen	(können)	(1 times)
konmen	(kommen)	(1 times)
konnt	(konnte)	(1 times)
konnter	(konnte)	(1 times)
konntrole	(Kontrolle)	(1 times)
konntte	(konnte)	(1 times)
konsentrirt	(konzentriert)	(1 times)
konte	(konnte)	(16 times)
konten	(konnten)	(4 times)
kontte	(konnte)	(1 times)
konzantrien	(konzentrieren)	(1 times)
konzentriet	(konzentriert)	(1 times)
konzentrirt	(konzentriert)	(1 times)
konzentrit	(konzentriert)	(1 times)
kopft	(klopft)	(1 times)
kopt	(kommt)	(1 times)
koput	(kaputt)	(1 times)
kotonks	(Kartons)	(1 times)
kpput	(kaputt)	(1 times)
krabeld	(krabbelt)	(1 times)
krabeln	(krabbeln)	(1 times)
krabelt	(krabbelt)	(2 times)
krablt	(krabbelt)	(1 times)
kralen	(Krallen)	(4 times)
kralt	(krallt)	(2 times)
kralte	(krallte)	(1 times)
kreftig	(kräftig)	(1 times)
kreftigen	(kräftigen)	(1 times)
kreuzun	(Kreuzung)	(1 times)
krickt	(kriegt)	(4 times)
kriekst	(kriegst)	(1 times)
krige	(kriege)	(1 times)
krigen	(kriegen)	(6 times)
krigst	(kriegst)	(2 times)
krikst	(kriegst)	(1 times)
krikt	(kriegt)	(5 times)
kronzertrien	(konzentrieren)	(1 times)
kumm	(Komm)	(1 times)
kumt	(kommt)	(1 times)
kurs	(kurz)	(1 times)
kurser	(kurzer)	(1 times)
kurwe	(Kurve)	(2 times)
könen	(können)	(7 times)
könte	(könnte)	(10 times)
köntest	(könntest)	(2 times)
kürz	(kurz)	(1 times)
ladet	(landet)	(1 times)
lagsam	(langsam)	(1 times)
langsamm	(langsam)	(1 times)
langsum	(langsam)	(1 times)
langweilich	(langweilig)	(2 times)
lanweilig	(langweilig)	(2 times)
lart	(lacht)	(1 times)
las	(lass)	(6 times)
laud	(laut)	(1 times)
laute	(lauter)	(1 times)
lecheln	(lächeln)	(1 times)
lechelte	(lächelte)	(5 times)
lechilt	(lächelt)	(1 times)
leckt	(legt)	(1 times)
leckts	(leckt)	(1 times)
ledsdensd	(letztens)	(1 times)
leherin	(Lehrerin)	(1 times)
lehrehren	(Lehrerin)	(1 times)
lehren	(leeren)	(2 times)
leim	(beim)	(1 times)
leiner	(Leine)	(1 times)
leit	(leid)	(3 times)
leken	(lecken)	(1 times)
lekommen	(bekommen)	(1 times)
lemeben	(leben)	(1 times)
lengst	(längst)	(1 times)
lenkst	(längst)	(1 times)
lerehrin	(Lehrerin)	(1 times)
leren	(leeren)	(1 times)
lerer	(Lehrer)	(1 times)
lererin	(Lehrerin)	(3 times)
lererrin	(Lehrerin)	(1 times)
lermh	(Lärm)	(1 times)
lest	(lässt)	(24 times)
lesten	(letzten)	(1 times)
lester	(letzter)	(1 times)
letzen	(letzten)	(2 times)
leuf	(läuft)	(1 times)
leufst	(läufst)	(1 times)
leuft	(läuft)	(10 times)
lezte	(letzte)	(1 times)
lib	(lieb)	(1 times)
liber	(lieber)	(1 times)
liblingstessen	(Lieblingsessen)	(1 times)
liencks	(links)	(1 times)
lienks	(links)	(2 times)
lies	(ließ)	(9 times)
liet	(Lied)	(1 times)
lif	(lief)	(1 times)
ligen	(liegen)	(5 times)
ligt	(liegt)	(11 times)
limlich	(nämlich)	(1 times)
lip	(lieb)	(1 times)
lis	(ließ)	(1 times)
lockat	(lockert)	(1 times)
loft	(läuft)	(1 times)
lohs	(los)	(1 times)
loker	(locker)	(2 times)
lokerer	(lockerer)	(1 times)
lolte	(sollte)	(1 times)
losGerisen	(losgerissen)	(1 times)
losfur	(losfuhr)	(1 times)
losgefaren	(losgefahren)	(1 times)
losgelaen	(losgelassen)	(1 times)
losgelasen	(losgelassen)	(3 times)
losgelaße	(losgelassen)	(1 times)
loslasen	(loslassen)	(2 times)
loss	(los)	(5 times)
luft	(läuft)	(1 times)
lusst	(Lust)	(1 times)
lächeld	(lächelnd)	(1 times)
lächerte	(lächelte)	(1 times)
läst	(lässt)	(15 times)
läste	(löste)	(1 times)
läuf	(läuft)	(1 times)
löchelt	(lächelt)	(1 times)
löft	(läuft)	(1 times)
löscher	(Löcher)	(1 times)
lüft	(läuft)	(1 times)
ma	(Mann)	(1 times)
machnn	(machen)	(1 times)
machs	(machst)	(2 times)
mah	(mal)	(1 times)
mahl	(mal)	(1 times)
mall	(mal)	(12 times)
mam	(man)	(1 times)
man	(Mann)	(59 times)
mann	(man)	(12 times)
mard	(macht)	(1 times)
mart	(macht)	(1 times)
maua	(Mauer)	(8 times)
medchen	(Mädchen)	(1 times)
meer	(mehr)	(6 times)
mehrkte	(merkte)	(1 times)
meinzt	(meinst)	(1 times)
menlichen	(männlichen)	(1 times)
mer	(mehr)	(62 times)
mer	(mir)	(1 times)
mercken	(merken)	(1 times)
merckt	(merkt)	(2 times)
merckten	(merkten)	(1 times)
mergt	(merkt)	(2 times)
merkwödga	(merkwürdiger)	(1 times)
merr	(mehr)	(1 times)
metchen	(Mädchen)	(2 times)
metter	(Meter)	(1 times)
meue	(neue)	(1 times)
mi	(mir)	(1 times)
mid	(mit)	(2 times)
miet	(mit)	(3 times)
milen	(mitten)	(1 times)
minte	(meinte)	(1 times)
minut	(Minute)	(1 times)
mis	(mit)	(1 times)
misst	(Mist)	(1 times)
mist	(mit)	(1 times)
mitanander	(miteinander)	(1 times)
mitarbeita	(Mitarbeiter)	(1 times)
mitbeckommen	(mitbekommen)	(1 times)
mitbring	(mitbringen)	(1 times)
miten	(mitten)	(3 times)
miternander	(miteinander)	(1 times)
mitgbracht	(mitgebracht)	(1 times)
mitgebacht	(mitgebracht)	(1 times)
mitgebrart	(mitgebracht)	(1 times)
mitgemomen	(mitgenommen)	(1 times)
mitgenomen	(mitgenommen)	(2 times)
mitkennome	(mitgenommen)	(1 times)
mitnehm	(mitnehmen)	(1 times)
mitnemen	(mitnehmen)	(8 times)
mitt	(mit)	(5 times)
moch	(noch)	(1 times)
mogen	(Morgen)	(1 times)
momen	(Moment)	(1 times)
momend	(Moment)	(2 times)
morgenz	(morgens)	(1 times)
mugirig	(neugierig)	(1 times)
mull	(Müll)	(1 times)
mus	(muss)	(15 times)
mussen	(müssen)	(4 times)
must	(musst)	(2 times)
muste	(musste)	(18 times)
musten	(mussten)	(4 times)
mächte	(möchte)	(1 times)
mädschen	(Mädchen)	(1 times)
möcht	(möchte)	(1 times)
möcklich	(möglich)	(2 times)
mögliech	(möglich)	(1 times)
möglige	(mögliche)	(1 times)
möl	(Müll)	(1 times)
möschde	(möchte)	(1 times)
möschte	(möchte)	(1 times)
müchte	(möchte)	(1 times)
mül	(Müll)	(1 times)
müleimer	(Mülleimer)	(1 times)
mülleimmer	(Mülleimer)	(1 times)
müsten	(müssten)	(3 times)
nac	(nach)	(5 times)
nachberen	(Nachbarin)	(1 times)
nachberin	(Nachbarin)	(2 times)
nachicht	(Nachricht)	(1 times)
nachmitag	(Nachmittag)	(2 times)
nachrich	(Nachricht)	(1 times)
nachste	(nächste)	(1 times)
nachsten	(nächsten)	(3 times)
nachtbar	(Nachbar)	(1 times)
nadürlich	(natürlich)	(1 times)
nah	(nach)	(4 times)
nahn	(nahm)	(1 times)
nahr	(nach)	(1 times)
nalütlich	(natürlich)	(1 times)
nardürlich	(natürlich)	(2 times)
narmens	(namens)	(1 times)
nartulich	(natürlich)	(1 times)
narturlich	(natürlich)	(2 times)
nartürlich	(Natürlich)	(1 times)
nartürlisch	(natürlich)	(1 times)
nas	(nass)	(15 times)
nat	(hat)	(1 times)
natrüchlich	(natürlich)	(2 times)
natulich	(natürlich)	(1 times)
naturlich	(natürlich)	(1 times)
natörlich	(natürlich)	(1 times)
natülich	(natürlich)	(1 times)
natürlig	(natürlich)	(1 times)
nebeneinnander	(nebeneinander)	(1 times)
nechme	(nehme)	(1 times)
nechmen	(nehmen)	(1 times)
nechsten	(nächsten)	(1 times)
negste	(nächste)	(1 times)
negßten	(nächsten)	(2 times)
nehbehn	(neben)	(1 times)
nehben	(neben)	(3 times)
nehe	(Nähe)	(3 times)
nehmlich	(nämlich)	(1 times)
nehmmen	(nehmen)	(1 times)
neil	(weil)	(1 times)
neinen	(einen)	(1 times)
neißt	(heißt)	(1 times)
neme	(nehme)	(1 times)
nemen	(nehmen)	(4 times)
nemlich	(nämlich)	(8 times)
nemmen	(nehmen)	(1 times)
nemst	(nimmst)	(1 times)
nerfig	(nervig)	(1 times)
net	(nett)	(1 times)
nete	(nette)	(1 times)
neteste	(netteste)	(1 times)
neueschkeiten	(Neuigkeiten)	(1 times)
neugirig	(neugierig)	(2 times)
neugirisch	(neugierig)	(1 times)
nich	(Nicht)	(1 times)
nich	(nicht)	(81 times)
nichd	(nicht)	(2 times)
nichnd	(nicht)	(1 times)
nichs	(nichts)	(1 times)
nicht's	(nichts)	(1 times)
nicht-	(nicht)	(1 times)
nichtt	(nicht)	(1 times)
nichtz	(nichts)	(5 times)
nicks	(nix)	(3 times)
nict	(nicht)	(1 times)
niecht	(nicht)	(3 times)
niehmant	(niemand)	(1 times)
nieman	(niemand)	(2 times)
niemant	(niemand)	(1 times)
niemd	(nimmt)	(1 times)
niemmd	(nimmt)	(1 times)
niemt	(nimmt)	(2 times)
nigs	(nix)	(3 times)
nigst	(nix)	(1 times)
nihmernd	(niemand)	(1 times)
nihn	(in)	(1 times)
niht	(nicht)	(1 times)
niks	(nix)	(5 times)
nim	(Nimm)	(1 times)
nimalz	(niemals)	(1 times)
nimand	(niemand)	(4 times)
nimant	(niemand)	(2 times)
nimlich	(nämlich)	(1 times)
nimmant	(niemand)	(1 times)
nimst	(nimmst)	(2 times)
nimt	(nimmt)	(3 times)
nischt	(nicht)	(1 times)
nochmall	(nochmal)	(4 times)
nocht	(noch)	(1 times)
nonoch	(noch)	(1 times)
notfal	(Notfall)	(1 times)
nu	(nur)	(1 times)
nuch	(nach)	(1 times)
numens	(namens)	(1 times)
numer	(Nummer)	(12 times)
nund	(und)	(1 times)
nurkemzwo	(nirgendwo)	(1 times)
nutiren	(notieren)	(1 times)
nwmer	(Nummer)	(1 times)
nägsten	(nächsten)	(2 times)
nähmisch	(nämlich)	(1 times)
nähmlich	(nämlich)	(3 times)
nänlich	(nämlich)	(1 times)
nästen	(nächsten)	(2 times)
nästes	(nächstes)	(1 times)
nätürlich	(natürlich)	(2 times)
nürgens	(nirgends)	(1 times)
nüzte	(nützte)	(1 times)
obt	(ob)	(1 times)
obwoll	(obwohl)	(2 times)
odwoll	(obwohl)	(1 times)
of	(auf)	(3 times)
ofen	(offen)	(3 times)
oke	(okay)	(2 times)
oky	(okay)	(1 times)
olso	(also)	(1 times)
olökrich	(glücklich)	(1 times)
om	(um)	(1 times)
omb	(ob)	(1 times)
op	(ob)	(5 times)
opt	(ob)	(1 times)
oub	(ob)	(1 times)
pa	(paar)	(3 times)
paKh	(Park)	(1 times)
paeinlich	(peinlich)	(1 times)
pag	(Park)	(1 times)
pakst	(packst)	(1 times)
pakt	(packt)	(1 times)
panig	(Panik)	(1 times)
par	(paar)	(15 times)
parg	(Park)	(1 times)
parr	(paar)	(3 times)
pas	(pass)	(6 times)
pasieren	(passieren)	(3 times)
pasiht	(passiert)	(1 times)
pasiren	(passieren)	(2 times)
pasirt	(passiert)	(15 times)
pasirte	(passierte)	(5 times)
passiren	(passieren)	(3 times)
passirt	(passiert)	(8 times)
past	(passt)	(2 times)
piestole	(Pistole)	(1 times)
pipsen	(Piepsen)	(1 times)
plackarte	(Plakate)	(1 times)
plackate	(Plakate)	(2 times)
plakarse	(Plakate)	(1 times)
plakarte	(Plakate)	(7 times)
plakatte	(Plakate)	(1 times)
plakt	(Plakat)	(1 times)
plarkarte	(Plakate)	(1 times)
plitchnass	(klitschnass)	(1 times)
plotzlich	(plötzlich)	(7 times)
plumste	(plumpste)	(2 times)
plölzlich	(plötzlich)	(1 times)
plöstlich	(Plötzlich)	(2 times)
plötslich	(plötzlich)	(2 times)
plötzlch	(plötzlich)	(1 times)
plötzlin	(plötzlich)	(1 times)
plöztlich	(plötzlich)	(1 times)
poblem	(Problem)	(1 times)
pötzlich	(plötzlich)	(1 times)
ragte	(sagte)	(2 times)
rakette	(Rakete)	(1 times)
rande	(rannte)	(2 times)
rante	(rannte)	(45 times)
rar	(war)	(1 times)
rau	(raus)	(1 times)
rauft	(ruft)	(1 times)
raurich	(traurig)	(1 times)
rausch	(raus)	(1 times)
rausgegommen	(rausgekommen)	(1 times)
rausgehkommen	(rausgekommen)	(1 times)
rausgehold	(rausgeholt)	(1 times)
rauß	(raus)	(1 times)
reberieren	(reparieren)	(1 times)
rechent	(rechnet)	(1 times)
rechtseitisch	(rechtzeitig)	(1 times)
redem	(jedem)	(1 times)
rehnt	(rennt)	(1 times)
reist	(reißt)	(17 times)
reizt	(reißt)	(1 times)
ren	(rein)	(1 times)
rend	(rennt)	(25 times)
rendt	(rennt)	(1 times)
renen	(rennen)	(5 times)
rennd	(rennt)	(9 times)
rennet	(rennt)	(1 times)
rent	(rennt)	(58 times)
rermißen	(vermissen)	(1 times)
reten	(retten)	(2 times)
retzel	(Rätsel)	(1 times)
reumt	(räumt)	(1 times)
richdich	(richtig)	(2 times)
richdig	(richtig)	(1 times)
richen	(riechen)	(1 times)
richtich	(richtig)	(3 times)
rif	(rief)	(3 times)
ris	(Riss)	(2 times)
ris	(riss)	(3 times)
rischtung	(Richtung)	(1 times)
risig	(riesig)	(2 times)
risige	(riesige)	(1 times)
ristig	(richtig)	(1 times)
riß	(riss)	(2 times)
roch	(noch)	(1 times)
ronter	(runter)	(1 times)
rrent	(rennt)	(1 times)
ruber	(rüber)	(1 times)
rucksag	(Rucksack)	(4 times)
rucksak	(Rucksack)	(4 times)
rugsag	(Rucksack)	(2 times)
ruhm	(rum)	(1 times)
ruig	(ruhig)	(1 times)
ruihg	(ruhig)	(1 times)
ruksack	(Rucksack)	(2 times)
ruksak	(Rucksack)	(4 times)
rumlauen	(rumlaufen)	(1 times)
runder	(runter)	(9 times)
rundergefalen	(runtergefallen)	(1 times)
rundergefallen	(runtergefallen)	(1 times)
rundter	(runter)	(2 times)
runeta	(runter)	(1 times)
runta	(runter)	(7 times)
runtar	(runter)	(1 times)
runtatu	(runter)	(1 times)
runterfale	(runterfallen)	(1 times)
runterfalen	(runterfallen)	(1 times)
runtergefalen	(runtergefallen)	(8 times)
runtergehfalen	(runtergefallen)	(1 times)
rusak	(Rucksack)	(3 times)
rusche	(Rutsche)	(1 times)
ruscht	(rutscht)	(1 times)
rutcht	(rutscht)	(1 times)
rweil	(weil)	(1 times)
rübber	(rüber)	(1 times)
rübehr	(rüber)	(1 times)
rücksag	(Rucksack)	(3 times)
rüher	(rüber)	(2 times)
s	(es)	(6 times)
sPasieren	(spazieren)	(1 times)
sa	(sah)	(2 times)
saKt	(sagt)	(1 times)
sachen	(suchen)	(1 times)
sackt	(sagt)	(6 times)
sackte	(sagte)	(3 times)
saein	(sein)	(1 times)
safte	(schaffte)	(1 times)
sagd	(sagt)	(2 times)
saglt	(sagt)	(1 times)
sagrt	(sagt)	(1 times)
sahgte	(sagte)	(2 times)
sahr	(sah)	(2 times)
sahs	(saß)	(6 times)
sahsen	(saßen)	(1 times)
saht	(sagt)	(2 times)
sahte	(sagte)	(4 times)
sai	(sie)	(1 times)
sakd	(sagt)	(1 times)
sakt	(sagt)	(9 times)
sakte	(sagte)	(4 times)
sameln	(sammeln)	(1 times)
samelt	(sammelt)	(1 times)
sane	(seine)	(1 times)
sann	(dann)	(1 times)
sas	(saß)	(2 times)
sass	(saß)	(1 times)
saua	(sauer)	(1 times)
sauba	(sauber)	(2 times)
saupa	(sauber)	(1 times)
saute	(schaute)	(2 times)
schPringt	(springt)	(1 times)
schaf=en	(schaffen)	(1 times)
schafen	(schaffen)	(1 times)
schaft	(schafft)	(6 times)
schalte	(Schalter)	(1 times)
schan	(schon)	(1 times)
schaniere	(Scharniere)	(1 times)
schbringt	(springt)	(1 times)
schdaupsauger	(Staubsauger)	(1 times)
scheler	(schneller)	(1 times)
schell	(schnell)	(2 times)
schemt	(schämt)	(3 times)
schicherheit	(Sicherheit)	(1 times)
schif	(schief)	(2 times)
schik	(schick)	(2 times)
schiken	(schicken)	(1 times)
schimft	(schimpft)	(1 times)
schin	(schön)	(1 times)
schlaft	(schläft)	(1 times)
schlap	(schlapp)	(1 times)
schleft	(schläft)	(1 times)
schleichst	(schleicht)	(1 times)
schleit	(schleicht)	(1 times)
schleunigs	(schleunigst)	(1 times)
schliest	(schließt)	(1 times)
schlim	(schlimm)	(1 times)
schlimeß	(Schlimmes)	(1 times)
schlislich	(schließlich)	(1 times)
schllechter	(schlechter)	(1 times)
schlum	(schlimm)	(2 times)
schlus	(Schluss)	(4 times)
schluß	(Schluss)	(1 times)
schläfschen	(Schläfchen)	(1 times)
schmeise	(schmeiße)	(1 times)
schmeisen	(schmeißen)	(5 times)
schmeist	(schmeißt)	(1 times)
schmeizt	(schmeißt)	(1 times)
schmeken	(schmecken)	(1 times)
schmekt	(schmeckt)	(1 times)
schmiltzt	(schmilzt)	(1 times)
schmüfelte	(schnüffelte)	(1 times)
schmütz	(Schmutz)	(1 times)
schnapt	(schnappt)	(1 times)
schneel	(schnell)	(1 times)
schnel	(schnell)	(55 times)
schneler	(schneller)	(4 times)
schnelle	(schnell)	(1 times)
schnnel	(schnell)	(2 times)
schnäl	(schnell)	(1 times)
schnüwelt	(schnüffelt)	(1 times)
schockiet	(schockiert)	(1 times)
schockirt	(schockiert)	(1 times)
schohn	(schon)	(2 times)
schok	(Schock)	(2 times)
schonen	(schönen)	(3 times)
schoner	(schöner)	(1 times)
schonn	(schon)	(5 times)
schonnen	(schönen)	(1 times)
schpazien	(spazieren)	(1 times)
schpazinen	(spazieren)	(1 times)
schpaziren	(spazieren)	(1 times)
schperter	(später)	(1 times)
schpetr	(später)	(1 times)
schpielen	(spielen)	(2 times)
schpilen	(spielen)	(1 times)
schprang	(sprang)	(1 times)
schprechen	(sprechen)	(1 times)
schprikt	(springt)	(1 times)
schprinKt	(springt)	(1 times)
schpringt	(springt)	(1 times)
schpäter	(später)	(2 times)
schrebtisch	(Schreibtisch)	(1 times)
schreg	(Schreck)	(1 times)
schreglich	(schrecklich)	(1 times)
schreiltisch	(Schreibtisch)	(1 times)
schrek	(Schreck)	(1 times)
schreklich	(schrecklich)	(1 times)
schretblisch	(Schreibtisch)	(1 times)
schri	(schrie)	(2 times)
schrib	(schrieb)	(1 times)
schricht	(spricht)	(2 times)
schrid	(Schritt)	(1 times)
schriete	(Schritte)	(2 times)
schrit	(Schritt)	(1 times)
schspaziren	(spazieren)	(1 times)
schtaub	(Staub)	(1 times)
schtaubsauger	(Staubsauger)	(1 times)
schten	(stehen)	(1 times)
schtet	(steht)	(2 times)
schtift	(Stift)	(2 times)
schtreich	(Streich)	(1 times)
schuchtern	(schüchtern)	(1 times)
schuhle	(Schule)	(1 times)
schuhn	(schon)	(1 times)
schuldich	(schuldig)	(1 times)
schulle	(Schule)	(2 times)
schun	(schon)	(2 times)
schwerigkeiten	(Schwierigkeiten)	(1 times)
schön	(schon)	(1 times)
schönnen	(schönen)	(4 times)
schönner	(schöner)	(1 times)
schüchel	(Schüssel)	(1 times)
schüsel	(Schüssel)	(1 times)
se	(sie)	(3 times)
seher	(sehen)	(1 times)
sehn	(sehen)	(4 times)
sehnsüschtig	(sehnsüchtig)	(1 times)
sehts	(setz)	(1 times)
sehtzen	(setzen)	(1 times)
sehtzt	(setzt)	(2 times)
sei	(sie)	(3 times)
seid	(seit)	(3 times)
seihner	(seiner)	(1 times)
seikt	(zeigt)	(1 times)
seina	(seiner)	(1 times)
selps	(selbst)	(1 times)
selpst	(selbst)	(1 times)
selzt	(selbst)	(1 times)
ser	(sehr)	(7 times)
ser-	(sehr)	(1 times)
sest	(setzt)	(1 times)
set	(sieht)	(2 times)
setsen	(setzen)	(1 times)
sezte	(setzte)	(1 times)
seßte	(setzte)	(1 times)
shie	(sie)	(1 times)
shnel	(schnell)	(1 times)
shönne	(schöne)	(1 times)
si	(Sie)	(2 times)
si	(sie)	(11 times)
sic	(sich)	(1 times)
sichs	(sich)	(1 times)
sid	(sieht)	(8 times)
siech	(sich)	(19 times)
sied	(sieht)	(22 times)
siee	(sie)	(1 times)
sieh	(Sie)	(1 times)
sieh	(sie)	(2 times)
sieich	(sich)	(1 times)
sien	(sein)	(3 times)
siend	(sind)	(12 times)
siene	(seine)	(1 times)
sient	(sind)	(2 times)
siesch	(sich)	(4 times)
siet	(sieht)	(35 times)
sietzt	(sitzt)	(1 times)
sih	(sich)	(2 times)
sikunden	(Sekunden)	(1 times)
simt	(sind)	(1 times)
sin	(Sinn)	(1 times)
sin	(sind)	(6 times)
sindt	(sind)	(1 times)
sinnd	(sind)	(1 times)
sint	(sind)	(15 times)
sisch	(sich)	(3 times)
sist	(ist)	(1 times)
sit	(sieht)	(2 times)
site	(Seite)	(1 times)
sitst	(sitzt)	(2 times)
sitz	(sitzt)	(1 times)
sitzenen	(sitzenden)	(1 times)
soagen	(Sorgen)	(1 times)
sochen	(Sachen)	(1 times)
sofahrt	(sofort)	(1 times)
sofard	(sofort)	(1 times)
sofart	(sofort)	(2 times)
sofat	(sofort)	(1 times)
sofohrt	(sofort)	(1 times)
sofor	(sofort)	(2 times)
soford	(sofort)	(1 times)
sofot	(sofort)	(2 times)
sofurd	(sofort)	(1 times)
soga	(sogar)	(4 times)
sogen	(Sorgen)	(2 times)
sogren	(Sorgen)	(1 times)
soh	(so)	(2 times)
sohfort	(sofort)	(1 times)
sohl	(soll)	(1 times)
sol	(soll)	(2 times)
solen	(Sollen)	(1 times)
solen	(sollen)	(2 times)
solln	(sollen)	(1 times)
solte	(sollte)	(7 times)
soltest	(solltest)	(1 times)
sonder	(sondern)	(3 times)
soniegen	(sonnigen)	(1 times)
sonigen	(sonnigen)	(8 times)
soningen	(sonnigen)	(1 times)
sonniegen	(sonnigen)	(1 times)
sons	(sonst)	(2 times)
sonzt	(sonst)	(2 times)
sorük	(zurück)	(1 times)
sovort	(sofort)	(3 times)
sowiso	(sowieso)	(1 times)
spaciren	(spazieren)	(2 times)
spanende	(spannende)	(1 times)
spang	(sprang)	(1 times)
sparang	(sprang)	(1 times)
spars	(Spaß)	(2 times)
spartziergang	(Spaziergang)	(1 times)
sparzieren	(spazieren)	(2 times)
sparziren	(spazieren)	(2 times)
spasieren	(spazieren)	(2 times)
spat	(spät)	(1 times)
spater	(später)	(1 times)
spatzieren	(spazieren)	(10 times)
spatziren	(spazieren)	(8 times)
spaziren	(spazieren)	(19 times)
spazirgang	(Spaziergang)	(4 times)
spazirn	(spazieren)	(1 times)
speder	(später)	(1 times)
speht	(spät)	(1 times)
speler	(später)	(1 times)
spet	(spät)	(1 times)
speter	(später)	(11 times)
spiellen	(spielen)	(1 times)
spilen	(spielen)	(14 times)
spingt	(springt)	(3 times)
spiß	(Spieß)	(1 times)
sprarchlos	(sprachlos)	(1 times)
sprengt	(springt)	(1 times)
spriegt	(springt)	(1 times)
springd	(springt)	(1 times)
sprinkt	(springt)	(9 times)
sprint	(springt)	(4 times)
sprit	(spricht)	(1 times)
spruch	(sprach)	(1 times)
sröstet	(tröstet)	(1 times)
ssurükgeden	(zurückgeben)	(1 times)
stacken	(starken)	(1 times)
stad	(Stadt)	(3 times)
staigt	(steigt)	(1 times)
standt	(stand)	(2 times)
stannd	(stand)	(1 times)
stant	(stand)	(3 times)
starcken	(starken)	(1 times)
start	(starrt)	(1 times)
stat	(Stadt)	(2 times)
staub-sauger	(Staubsauger)	(1 times)
staubsauga	(Staubsauger)	(1 times)
staup	(Staub)	(3 times)
staupsauber	(Staubsauger)	(1 times)
staupsauger	(Staubsauger)	(1 times)
stausauger	(Staubsauger)	(5 times)
stautsaugter	(Staubsauger)	(1 times)
ste	(steh)	(1 times)
stehd	(steht)	(1 times)
stehlt	(stellt)	(2 times)
stehn	(Stehen)	(1 times)
stehn	(stehen)	(7 times)
steigehn	(steigen)	(1 times)
steikt	(steigt)	(3 times)
steken	(stecken)	(1 times)
stele	(Stelle)	(1 times)
stelen	(stellen)	(1 times)
stelhte	(stellte)	(1 times)
stelt	(stellt)	(1 times)
steraße	(Straße)	(1 times)
stet	(steht)	(11 times)
steth	(steht)	(1 times)
stieft	(Stift)	(2 times)
stiek	(stieg)	(2 times)
stig	(stieg)	(8 times)
stime	(Stimme)	(1 times)
stimmme	(Stimme)	(1 times)
stimt	(stimmt)	(2 times)
stit	(steht)	(1 times)
stoch	(Stock)	(1 times)
stolbert	(stolpert)	(1 times)
stolpart	(stolpert)	(1 times)
stoop	(stopp)	(1 times)
stopen	(Stoppen)	(1 times)
stopen	(stoppen)	(2 times)
stopfte	(stoppte)	(1 times)
stopt	(stoppt)	(1 times)
stozt	(stürzt)	(1 times)
straf	(straff)	(1 times)
strallte	(strahlte)	(1 times)
stram	(stramm)	(1 times)
strarken	(starken)	(1 times)
strase	(Straße)	(1 times)
strasse	(Straße)	(2 times)
stuck	(Stück)	(1 times)
stug	(Stück)	(2 times)
stuk	(Stück)	(1 times)
stul	(Stuhl)	(1 times)
stummt	(stimmt)	(1 times)
sturzt	(stürzt)	(2 times)
stzät	(setzt)	(1 times)
stük	(Stück)	(2 times)
stüme	(Stimme)	(2 times)
su	(zu)	(4 times)
suchd	(sucht)	(1 times)
sum	(zum)	(3 times)
swar	(zwar)	(1 times)
sätzt	(setzt)	(1 times)
sönen	(schönen)	(1 times)
söner	(schöner)	(2 times)
sönes	(schönes)	(1 times)
söniegen	(sonnigen)	(1 times)
süss	(süß)	(2 times)
tache	(Tasche)	(1 times)
tagges	(Tages)	(1 times)
tah	(tat)	(1 times)
tail	(Teil)	(1 times)
tarurig	(traurig)	(2 times)
tasch	(Tasche)	(9 times)
tasächlich	(tatsächlich)	(1 times)
tatsechlich	(tatsächlich)	(1 times)
taurich	(traurig)	(1 times)
taurig	(traurig)	(1 times)
tedi	(Teddy)	(1 times)
tedy	(Teddy)	(4 times)
tehma	(Thema)	(1 times)
telefohn	(Telefon)	(1 times)
telefonirt	(telefoniert)	(2 times)
telefonnumer	(Telefonnummer)	(2 times)
telefonnuner	(Telefonnummer)	(1 times)
telefonumer	(Telefonnummer)	(1 times)
telerenit	(telefoniert)	(1 times)
telfon	(Telefon)	(1 times)
tellefon	(Telefon)	(1 times)
telofon	(Telefon)	(3 times)
telofonNumer	(Telefonnummer)	(1 times)
telvonit	(telefoniert)	(1 times)
ten	(denn)	(1 times)
tepich	(Teppich)	(2 times)
teuere	(teure)	(1 times)
tiaurich	(traurig)	(1 times)
tiriefen	(treffen)	(1 times)
tischört	(T-Shirt)	(1 times)
toroPfen	(Tropfen)	(1 times)
tote	(Tode)	(1 times)
tozdem	(trotzdem)	(1 times)
tragich	(tragisch)	(1 times)
trairig	(traurig)	(1 times)
trapfen	(Tropfen)	(1 times)
trarich	(traurig)	(2 times)
trarig	(traurig)	(1 times)
trauchrig	(traurig)	(1 times)
trauchrisch	(traurig)	(1 times)
trauf	(drauf)	(1 times)
trauig	(traurig)	(1 times)
trauisch	(traurig)	(1 times)
traureg	(traurig)	(3 times)
traurg	(traurig)	(2 times)
trauri	(traurig)	(1 times)
traurich	(traurig)	(52 times)
traurieg	(traurig)	(2 times)
traurik	(traurig)	(3 times)
traurisch	(traurig)	(6 times)
trefen	(treffen)	(12 times)
trenen	(Tränen)	(2 times)
trepe	(Treppe)	(1 times)
trieft	(trifft)	(1 times)
trift	(trifft)	(5 times)
trostem	(trotzdem)	(1 times)
trostet	(tröstet)	(1 times)
trotdem	(trotzdem)	(1 times)
trotztem	(trotzdem)	(1 times)
trotztim	(trotzdem)	(1 times)
trourig	(traurig)	(1 times)
trozdem	(trotzdem)	(3 times)
trpfen	(Tropfen)	(1 times)
trraurig	(traurig)	(1 times)
truarig	(traurig)	(1 times)
trunter	(drunter)	(1 times)
trännen	(Tränen)	(1 times)
tröpfen	(Tropfen)	(1 times)
trüsten	(trösten)	(1 times)
ttrenen	(Tränen)	(1 times)
tu	(du)	(7 times)
tuen	(tun)	(3 times)
tuhen	(tun)	(5 times)
tuhn	(tun)	(1 times)
tur	(Tür)	(1 times)
tursche	(Tasche)	(1 times)
töte	(Tüte)	(2 times)
u	(du)	(2 times)
ubehaubt	(überhaupt)	(1 times)
uber	(über)	(11 times)
uberall	(überall)	(2 times)
ubergluglich	(überglücklich)	(1 times)
uberglücklich	(überglücklich)	(1 times)
uberrall	(überall)	(1 times)
uberschrift	(Überschrift)	(1 times)
ubrig	(übrig)	(2 times)
ud	(und)	(2 times)
udn	(und)	(1 times)
umSons	(umsonst)	(1 times)
umahrmte	(umarmte)	(1 times)
umamd	(umarmt)	(1 times)
umamen	(umarmen)	(3 times)
umamten	(umarmten)	(3 times)
umarmd	(umarmt)	(1 times)
umarmde	(umarmte)	(2 times)
umarmdend	(umarmten)	(1 times)
umarmmte	(umarmte)	(1 times)
umarmtete	(umarmte)	(1 times)
umarte	(umarmte)	(2 times)
umbedieng	(unbedingt)	(1 times)
umbedinkt	(unbedingt)	(2 times)
umd	(und)	(1 times)
umgedret	(umgedreht)	(2 times)
umglük	(Unglück)	(1 times)
umramen	(umarmen)	(1 times)
umsontst	(umsonst)	(1 times)
umsonzt	(umsonst)	(1 times)
un	(an)	(1 times)
un	(und)	(25 times)
una	(und)	(3 times)
unarmte	(umarmte)	(1 times)
unauffelig	(unauffällig)	(1 times)
und-	(und)	(1 times)
undd	(und)	(1 times)
unden	(unten)	(1 times)
unds	(und)	(1 times)
undten	(unten)	(1 times)
undter	(unter)	(2 times)
unfal	(Unfall)	(2 times)
unfähr	(unfair)	(1 times)
ungeduldi	(ungeduldig)	(1 times)
ungehwöhnliche	(ungewöhnliche)	(1 times)
unger	(Hunger)	(2 times)
unglauplich	(unglaublich)	(1 times)
unl	(und)	(1 times)
unmeschtich	(ohnmächtig)	(1 times)
unn	(und)	(1 times)
unnter	(unter)	(1 times)
uns	(und)	(1 times)
unsehre	(unsere)	(1 times)
unt	(und)	(23 times)
untaricht	(Unterricht)	(1 times)
untawegs	(unterwegs)	(1 times)
unte	(unter)	(1 times)
unterhalten-	(unterhalten)	(1 times)
unterich	(Unterricht)	(1 times)
untericht	(Unterricht)	(8 times)
unterist	(Unterricht)	(1 times)
unternemen	(unternehmen)	(1 times)
unterrich	(Unterricht)	(1 times)
unterwecks	(unterwegs)	(1 times)
unterweks	(unterwegs)	(2 times)
unterwex	(unterwegs)	(1 times)
unvall	(Unfall)	(1 times)
unvorsigtig	(unvorsichtig)	(1 times)
unz	(uns)	(1 times)
uuf	(auf)	(2 times)
uun	(und)	(1 times)
uund	(und)	(2 times)
vLog	(flog)	(1 times)
vackelig	(wackelig)	(1 times)
vakelt	(wackelt)	(1 times)
val	(weil)	(1 times)
vallen	(fallen)	(1 times)
valoren	(verloren)	(2 times)
vartet	(wartet)	(3 times)
vas	(was)	(1 times)
vasst	(fast)	(1 times)
vast	(fast)	(2 times)
veertig	(fertig)	(1 times)
veg	(weg)	(1 times)
vegen	(wegen)	(1 times)
vegessene	(vergessene)	(1 times)
vegiss	(vergiss)	(2 times)
vehg	(Weg)	(1 times)
vehrschwundende	(verschwundene)	(1 times)
veil	(weil)	(2 times)
veile	(Weile)	(1 times)
vek	(weg)	(1 times)
velore	(verloren)	(2 times)
veloren	(verloren)	(2 times)
vemist	(vermisst)	(1 times)
venster	(Fenster)	(2 times)
vensterbank	(Fensterbank)	(1 times)
venzter	(Fenster)	(1 times)
vepassen	(verpassen)	(1 times)
ver-sucht	(versucht)	(1 times)
verblüft	(verblüfft)	(1 times)
verchwunden	(verschwunden)	(2 times)
verchwwnden	(verschwunden)	(1 times)
verdamten	(verdammten)	(1 times)
vergesene	(vergessene)	(1 times)
vergesesn	(vergessen)	(1 times)
vergiest	(vergisst)	(2 times)
vergist	(vergisst)	(7 times)
verhroren	(verloren)	(1 times)
verlarene	(verlorene)	(1 times)
verlayren	(verloren)	(1 times)
verleicht	(vielleicht)	(1 times)
verlohren	(verloren)	(2 times)
verlore	(verloren)	(1 times)
vermist	(vermisst)	(38 times)
vermiste	(vermisste)	(3 times)
vermisten	(vermissten)	(1 times)
vermistt	(vermisst)	(1 times)
vermißt	(vermisst)	(1 times)
vermmist	(vermisst)	(1 times)
verpast	(verpasst)	(1 times)
verrgesen	(vergessen)	(1 times)
verrschwunden	(verschwunden)	(2 times)
versehn	(Versehen)	(1 times)
versen	(Versehen)	(1 times)
vershut	(versucht)	(1 times)
verstakt	(versteckt)	(1 times)
verstecks	(versteckst)	(1 times)
verstekt	(versteckt)	(3 times)
verstekte	(versteckte)	(1 times)
versträut	(verstreut)	(1 times)
vertich	(fertig)	(5 times)
vertig	(fertig)	(14 times)
verwandert	(verwundert)	(1 times)
verwirte	(verwirrte)	(1 times)
verzfeifelt	(verzweifelt)	(1 times)
verzweifeld	(verzweifelt)	(2 times)
verzweiflet	(verzweifelt)	(1 times)
verzweihfelt	(verzweifelt)	(1 times)
verzweilfelt	(verzweifelt)	(1 times)
verückt	(verrückt)	(4 times)
verückte	(verrückte)	(3 times)
verükte	(verrückte)	(1 times)
vest	(fest)	(2 times)
vestgehalten	(festgehalten)	(2 times)
vieder	(wieder)	(1 times)
viel	(fiel)	(10 times)
vielecht	(vielleicht)	(1 times)
vieleicht	(vielleicht)	(5 times)
vielen	(fielen)	(1 times)
viellen	(Vielen)	(1 times)
viellen	(vielen)	(1 times)
vieln	(vielen)	(1 times)
vile	(viele)	(1 times)
vileicht	(Vielleicht)	(1 times)
ving	(fing)	(2 times)
vinger	(Finger)	(1 times)
virtelstunde	(Viertelstunde)	(1 times)
vliegt	(fliegt)	(1 times)
vogesen	(vergessen)	(1 times)
vol	(voll)	(2 times)
voler	(voller)	(1 times)
volkomen	(vollkommen)	(1 times)
voloren	(verloren)	(1 times)
volte	(wollte)	(1 times)
vonn	(von)	(1 times)
vorloren	(verloren)	(1 times)
vote	(Pfote)	(1 times)
vragt	(fragt)	(1 times)
vreude	(Freude)	(3 times)
vridlich	(friedlich)	(1 times)
vro	(froh)	(1 times)
vroch	(Frosch)	(3 times)
vroh	(froh)	(1 times)
vrölich	(fröhlich)	(1 times)
vum	(vom)	(1 times)
vun	(von)	(1 times)
vängt	(fängt)	(1 times)
wa	(was)	(1 times)
wache	(Woche)	(1 times)
wachtet	(wartet)	(4 times)
wachtete	(wartete)	(1 times)
wackliger	(wackeliger)	(1 times)
waeiter	(weiter)	(1 times)
wagun	(Wagen)	(1 times)
wah	(war)	(1 times)
wahh	(war)	(1 times)
wahr	(war)	(38 times)
wahren	(waren)	(6 times)
wahrm	(warm)	(1 times)
wahrtet	(wartet)	(1 times)
wahrtette	(wartete)	(1 times)
waint	(weint)	(1 times)
wais	(weiß)	(1 times)
waiter	(weiter)	(1 times)
wakelig	(wackelig)	(1 times)
wakeln	(wackeln)	(2 times)
wakelt	(wackelt)	(3 times)
wal	(weil)	(9 times)
wall	(weil)	(2 times)
wallen	(fallen)	(1 times)
wallte	(wollte)	(1 times)
wan	(wann)	(1 times)
ward	(wart)	(1 times)
wardet	(wartet)	(4 times)
warheen	(waren)	(1 times)
warren	(waren)	(2 times)
warted	(wartet)	(9 times)
wartede	(wartete)	(1 times)
warun	(Warum)	(1 times)
warun	(warum)	(1 times)
warwm	(warum)	(1 times)
wass	(was)	(5 times)
water	(weiter)	(2 times)
watet	(wartet)	(16 times)
watete	(wartete)	(4 times)
watte	(warte)	(1 times)
we	(weh)	(1 times)
wecKgelaufen	(weggelaufen)	(1 times)
wecKlaufen	(weglaufen)	(1 times)
wech	(weg)	(5 times)
weck	(weg)	(12 times)
weckgelaufen	(weggelaufen)	(6 times)
weckseln	(wechseln)	(1 times)
weder	(wieder)	(1 times)
wegetan	(wehgetan)	(1 times)
wegetanrn	(wehgetan)	(1 times)
weggehlaufen	(weggelaufen)	(1 times)
weggelt	(weggeht)	(1 times)
weggerant	(weggerannt)	(1 times)
wegleift	(wegläuft)	(1 times)
wegseln	(wechseln)	(1 times)
wehg	(weg)	(1 times)
wehgen	(wegen)	(1 times)
wehk	(weg)	(2 times)
wehre	(wäre)	(1 times)
weider	(weiter)	(1 times)
weider	(wieder)	(1 times)
weiel	(weil)	(4 times)
weihl	(weil)	(1 times)
weihnen	(weinen)	(1 times)
weil	(Weile)	(1 times)
weiler	(weiter)	(2 times)
weill	(weil)	(9 times)
weind	(weint)	(36 times)
weinenrn	(weinen)	(1 times)
weinent	(weinend)	(5 times)
weinete	(weinte)	(1 times)
weinnen	(weinen)	(1 times)
weinnent	(weinend)	(1 times)
weints	(weinst)	(1 times)
weis	(weiß)	(15 times)
weiss	(weiß)	(2 times)
weisst	(weißt)	(1 times)
weist	(weißt)	(9 times)
weit	(weil)	(1 times)
weita	(weiter)	(1 times)
weite	(weinte)	(1 times)
weite	(weiter)	(2 times)
weitee	(weiter)	(1 times)
wek	(Weg)	(2 times)
wek	(weg)	(9 times)
wekgelauf	(weggelaufen)	(1 times)
wekgelaufen	(weggelaufen)	(7 times)
wekgerant	(weggerannt)	(2 times)
wekselt	(wechselt)	(2 times)
wel	(will)	(1 times)
welld	(Welt)	(1 times)
wellt	(fällt)	(1 times)
welt	(fällt)	(1 times)
wemand	(jemand)	(2 times)
wen	(wenn)	(23 times)
wende	(Wände)	(2 times)
wenigsten	(wenigstens)	(1 times)
wenster	(Fenster)	(1 times)
werd	(wert)	(1 times)
were	(wäre)	(6 times)
werend	(während)	(5 times)
wererend	(während)	(1 times)
wergessen	(vergessen)	(1 times)
werschwundene	(verschwundene)	(1 times)
wertig	(fertig)	(2 times)
weter	(Wetter)	(1 times)
wg	(weg)	(1 times)
wida	(wieder)	(4 times)
wider	(wieder)	(160 times)
widergefunden	(wiedergefunden)	(1 times)
widersehn	(Wiedersehen)	(1 times)
widerzusehen	(wiederzusehen)	(2 times)
widr	(wieder)	(1 times)
wieber	(wieder)	(1 times)
wieda	(wieder)	(4 times)
wiedersehn	(Wiedersehen)	(1 times)
wiedr	(wieder)	(1 times)
wiel	(fiel)	(1 times)
wiel	(will)	(11 times)
wiell	(will)	(1 times)
wiend	(Wind)	(1 times)
wienkte	(winkte)	(1 times)
wierft	(wirft)	(3 times)
wik	(weg)	(2 times)
wil	(will)	(20 times)
wils	(Willst)	(1 times)
winckte	(winkte)	(1 times)
winde	(finde)	(1 times)
wingte	(winkte)	(2 times)
wircklich	(wirklich)	(1 times)
wirglich	(wirklich)	(2 times)
wirt	(wird)	(5 times)
wishen	(wissen)	(1 times)
wist	(Wisst)	(1 times)
wohloren	(verloren)	(1 times)
wohlte	(wollte)	(4 times)
wohnug	(Wohnung)	(1 times)
wok	(weg)	(1 times)
wol	(wohl)	(1 times)
wolde	(wollte)	(2 times)
wolehn	(wollen)	(1 times)
wolen	(wollen)	(7 times)
woll	(wohl)	(6 times)
wolt	(wollte)	(1 times)
wolte	(wollte)	(127 times)
woltle	(wollte)	(1 times)
won	(von)	(3 times)
wonderschönen	(wunderschönen)	(1 times)
wonhin	(wohin)	(1 times)
wont	(wohnt)	(1 times)
wonzimmer	(Wohnzimmer)	(1 times)
wor	(war)	(1 times)
wragte	(fragte)	(2 times)
wuhren	(waren)	(1 times)
wulte	(wollte)	(1 times)
wunderschones	(wunderschönes)	(1 times)
wurklich	(wirklich)	(1 times)
wusse	(wusste)	(1 times)
wuste	(wusste)	(28 times)
wusten	(wussten)	(4 times)
wäg	(weg)	(2 times)
wägwerfen	(wegwerfen)	(1 times)
währ	(wäre)	(1 times)
währe	(wäre)	(1 times)
wänd	(Wand)	(1 times)
wärend	(während)	(2 times)
wünderschöner	(wunderschöner)	(1 times)
würd	(wird)	(2 times)
würklich	(wirklich)	(1 times)
wüt	(wird)	(1 times)
wütent	(wütend)	(4 times)
ya	(ja)	(4 times)
yemand	(jemand)	(3 times)
yemant	(jemand)	(3 times)
yetz	(jetzt)	(1 times)
yetzt	(jetzt)	(4 times)
zabrochenden	(zerbrochenen)	(1 times)
zaulerei	(Zauberei)	(1 times)
zebrochene	(zerbrochene)	(1 times)
zehrbliterte	(zersplitterte)	(1 times)
zei	(Zeit)	(1 times)
zeik	(zeig)	(1 times)
zeikt	(zeigt)	(1 times)
zerbochene	(zerbrochene)	(1 times)
zerbrauchene	(zerbrochene)	(1 times)
zereist	(zerreißt)	(2 times)
zerissen	(zerrissen)	(1 times)
zerrieß	(zerriss)	(1 times)
zerrießen	(zerrissen)	(1 times)
zerris	(zerriss)	(2 times)
zetel	(Zettel)	(2 times)
zeuknis	(Zeugnis)	(1 times)
zich	(sich)	(1 times)
ziet	(zieht)	(3 times)
zihen	(ziehen)	(2 times)
ziht	(zieht)	(1 times)
zimer	(Zimmer)	(1 times)
zimlich	(ziemlich)	(2 times)
zitzt	(sitzt)	(2 times)
zohg	(zog)	(1 times)
zoll	(soll)	(1 times)
zraf	(traf)	(1 times)
zu-	(zu)	(1 times)
zufriden	(zufrieden)	(10 times)
zugig	(zügig)	(1 times)
zuh	(zu)	(2 times)
zuh	(zur)	(1 times)
zukük	(zurück)	(1 times)
zumm	(zum)	(1 times)
zurhause	(Zuhause)	(1 times)
zurrück	(zurück)	(1 times)
zuruck	(zurück)	(4 times)
zuruk	(zurück)	(3 times)
zuröck	(zurück)	(1 times)
zurüg	(zurück)	(3 times)
zurüggekomen	(zurückgekommen)	(1 times)
zurük	(zurück)	(19 times)
zurükgebracht	(zurückgebracht)	(1 times)
zurükgekomin	(zurückgekommen)	(1 times)
zurüq	(zurück)	(1 times)
zussamen	(zusammen)	(2 times)
zussammen	(zusammen)	(1 times)
zuvriden	(zufrieden)	(1 times)
zwichen	(zwischen)	(3 times)
zärrt	(zerrt)	(1 times)
zürck	(zurück)	(2 times)
zürick	(zurück)	(1 times)
züruck	(zurück)	(5 times)
züruk	(zurück)	(1 times)
zürück	(zurück)	(5 times)
zürückkommt	(zurückkommt)	(1 times)
zürüg	(zurück)	(1 times)
zürük	(zurück)	(2 times)
Öfnete	(öffnete)	(1 times)
Überaschung	(Überraschung)	(4 times)
Überraschchung	(Überraschung)	(1 times)
Überraschund	(Überraschung)	(1 times)
Ürgendwan	(Irgendwann)	(1 times)
äge	(Ecke)	(1 times)
ägstra	(extra)	(1 times)
ällterer	(älterer)	(1 times)
änglich	(endlich)	(1 times)
ängslich	(ängstlich)	(1 times)
ärgär	(Ärger)	(1 times)
äuch	(euch)	(1 times)
öfnet	(öffnet)	(1 times)
öfnete	(öffnete)	(4 times)
öfnette	(öffnete)	(1 times)
öfnte	(öffnete)	(1 times)
üba	(über)	(4 times)
übeal	(überall)	(1 times)
über-	(über)	(1 times)
überal	(überall)	(21 times)
überalh	(überall)	(1 times)
überalle	(überall)	(1 times)
überaschung	(Überraschung)	(9 times)
überglüglich	(überglücklich)	(2 times)
überglüklich	(überglücklich)	(4 times)
überlegb	(überlegt)	(1 times)
überlekt	(überlegt)	(1 times)
überracht	(überrascht)	(2 times)
überral	(überall)	(1 times)
überrall	(überall)	(1 times)
überrast	(überrascht)	(1 times)
überzeügt	(überzeugt)	(1 times)
üder	(über)	(5 times)
ülberall	(überall)	(1 times)
üüber	(über)	(1 times)
